state_name,county_fips,county_name,votes_gop,votes_dem,total_votes,diff,per_gop,per_dem,per_point_diff
Alaska,02013,Alaska,130413,93003,246588,37410,0.528870018,0.377159472,0.151710546
Alaska,02016,Alaska,130413,93003,246588,37410,0.528870018,0.377159472,0.151710546
Alaska,02020,Alaska,130413,93003,246588,37410,0.528870018,0.377159472,0.151710546
Alaska,02050,Alaska,130413,93003,246588,37410,0.528870018,0.377159472,0.151710546
Alaska,02060,Alaska,130413,93003,246588,37410,0.528870018,0.377159472,0.151710546
Alaska,02068,Alaska,130413,93003,246588,37410,0.528870018,0.377159472,0.151710546
Alaska,02070,Alaska,130413,93003,246588,37410,0.528870018,0.377159472,0.151710546
Alaska,02090,Alaska,130413,93003,246588,37410,0.528870018,0.377159472,0.151710546
Alaska,02100,Alaska,130413,93003,246588,37410,0.528870018,0.377159472,0.151710546
Alaska,02105,Alaska,130413,93003,246588,37410,0.528870018,0.377159472,0.151710546
Alaska,02110,Alaska,130413,93003,246588,37410,0.528870018,0.377159472,0.151710546
Alaska,02122,Alaska,130413,93003,246588,37410,0.528870018,0.377159472,0.151710546
Alaska,02130,Alaska,130413,93003,246588,37410,0.528870018,0.377159472,0.151710546
Alaska,02150,Alaska,130413,93003,246588,37410,0.528870018,0.377159472,0.151710546
Alaska,02164,Alaska,130413,93003,246588,37410,0.528870018,0.377159472,0.151710546
Alaska,02170,Alaska,130413,93003,246588,37410,0.528870018,0.377159472,0.151710546
Alaska,02180,Alaska,130413,93003,246588,37410,0.528870018,0.377159472,0.151710546
Alaska,02185,Alaska,130413,93003,246588,37410,0.528870018,0.377159472,0.151710546
Alaska,02188,Alaska,130413,93003,246588,37410,0.528870018,0.377159472,0.151710546
Alaska,02195,Alaska,130413,93003,246588,37410,0.528870018,0.377159472,0.151710546
Alaska,02198,Alaska,130413,93003,246588,37410,0.528870018,0.377159472,0.151710546
Alaska,02220,Alaska,130413,93003,246588,37410,0.528870018,0.377159472,0.151710546
Alaska,02230,Alaska,130413,93003,246588,37410,0.528870018,0.377159472,0.151710546
Alaska,02240,Alaska,130413,93003,246588,37410,0.528870018,0.377159472,0.151710546
Alaska,02261,Alaska,130413,93003,246588,37410,0.528870018,0.377159472,0.151710546
Alaska,02270,Alaska,130413,93003,246588,37410,0.528870018,0.377159472,0.151710546
Alaska,02275,Alaska,130413,93003,246588,37410,0.528870018,0.377159472,0.151710546
Alaska,02282,Alaska,130413,93003,246588,37410,0.528870018,0.377159472,0.151710546
Alaska,02290,Alaska,130413,93003,246588,37410,0.528870018,0.377159472,0.151710546
Alabama,01001,Autauga County,18110,5908,24661,12202,0.734357893,0.23956855,0.494789343
Alabama,01003,Baldwin County,72780,18409,94090,54371,0.77351472,0.195653098,0.577861622
Alabama,01005,Barbour County,5431,4848,10390,583,0.522714148,0.466602502,0.056111646
Alabama,01007,Bibb County,6733,1874,8748,4859,0.769661637,0.214220393,0.555441244
Alabama,01009,Blount County,22808,2150,25384,20658,0.898518752,0.084699023,0.813819729
Alabama,01011,Bullock County,1139,3530,4701,-2391,0.242288875,0.750904063,-0.508615188
Alabama,01013,Butler County,4891,3716,8685,1175,0.563154865,0.427864134,0.135290731
Alabama,01015,Calhoun County,32803,13197,47376,19606,0.692396994,0.278558764,0.41383823
Alabama,01017,Chambers County,7803,5763,13778,2040,0.56633764,0.418275512,0.148062128
Alabama,01019,Cherokee County,8809,1524,10503,7285,0.838712749,0.1451014,0.693611349
Alabama,01021,Chilton County,15068,2909,18255,12159,0.825417694,0.159353602,0.666064092
Alabama,01023,Choctaw County,4102,3109,7268,993,0.564391855,0.427765548,0.136626307
Alabama,01025,Clarke County,7109,5712,12936,1397,0.549551639,0.441558442,0.107993197
Alabama,01027,Clay County,5230,1234,6572,3996,0.795800365,0.187766281,0.608034084
Alabama,01029,Cleburne County,5738,684,6532,5054,0.878444581,0.104715248,0.773729333
Alabama,01031,Coffee County,15825,4194,20513,11631,0.771462,0.204455711,0.567006289
Alabama,01033,Colbert County,16718,7296,24626,9422,0.678875985,0.296272233,0.382603752
Alabama,01035,Conecuh County,3413,3069,6543,344,0.521626165,0.469050894,0.052575271
Alabama,01037,Coosa County,3376,1780,5223,1596,0.646371817,0.340800306,0.305571511
Alabama,01039,Covington County,13222,2379,15818,10843,0.835883171,0.15039828,0.685484891
Alabama,01041,Crenshaw County,4511,1663,6252,2848,0.721529111,0.265994882,0.455534229
Alabama,01043,Cullman County,32734,3730,37278,29004,0.878105049,0.100059016,0.778046033
Alabama,01045,Dale County,13798,4408,18617,9390,0.741150561,0.236772842,0.504377719
Alabama,01047,Dallas County,5784,12826,18730,-7042,0.308809397,0.684783769,-0.375974372
Alabama,01049,DeKalb County,21779,3682,26086,18097,0.834892279,0.141148509,0.69374377
Alabama,01051,Elmore County,27619,8436,36905,19183,0.748380978,0.228586912,0.519794066
Alabama,01053,Escambia County,10282,4698,15213,5584,0.675869322,0.308814829,0.367054493
Alabama,01055,Etowah County,32132,10350,43474,21782,0.739108433,0.238073331,0.501035102
Alabama,01057,Fayette County,6705,1358,8196,5347,0.818081991,0.165690581,0.65239141
Alabama,01059,Franklin County,9466,2197,11955,7269,0.791802593,0.18377248,0.608030113
Alabama,01061,Geneva County,9967,1522,11659,8445,0.854876061,0.130542928,0.724333133
Alabama,01063,Greene County,838,4006,4862,-3168,0.172357055,0.823940765,-0.65158371
Alabama,01065,Hale County,3172,4772,8010,-1600,0.396004994,0.595755306,-0.199750312
Alabama,01067,Henry County,5623,2286,8017,3337,0.701384558,0.285144069,0.416240489
Alabama,01069,Houston County,30567,10547,42030,20020,0.727266238,0.250939805,0.476326433
Alabama,01071,Jackson County,16643,3663,20785,12980,0.800721674,0.17623286,0.624488814
Alabama,01073,Jefferson County,130614,151581,290111,-20967,0.450220778,0.522493115,-0.072272337
Alabama,01075,Lamar County,5819,1035,6931,4784,0.839561391,0.149329101,0.69023229
Alabama,01077,Lauderdale County,27735,9877,38813,17858,0.714580166,0.254476593,0.460103573
Alabama,01079,Lawrence County,10732,3611,14623,7121,0.73391233,0.246939752,0.486972578
Alabama,01081,Lee County,34321,20987,57668,13334,0.595148089,0.363928002,0.231220087
Alabama,01083,Limestone County,28824,9340,39400,19484,0.731573604,0.237055838,0.494517766
Alabama,01085,Lowndes County,1751,4882,6676,-3131,0.262282804,0.731276213,-0.468993409
Alabama,01087,Macon County,1394,7237,8748,-5843,0.159350709,0.827274806,-0.667924097
Alabama,01089,Madison County,89199,62435,159473,26764,0.559336063,0.39150828,0.167827783
Alabama,01091,Marengo County,5224,5607,10948,-383,0.477164779,0.512148338,-0.034983559
Alabama,01093,Marion County,11273,1432,12912,9841,0.873063817,0.110904585,0.762159232
Alabama,01095,Marshall County,29217,4913,34965,24304,0.835607036,0.140511941,0.695095095
Alabama,01097,Mobile County,91087,68429,163387,22658,0.557492334,0.41881545,0.138676884
Alabama,01099,Monroe County,5771,4310,10185,1461,0.566617575,0.42317133,0.143446245
Alabama,01101,Montgomery County,33928,58669,94572,-24741,0.358753119,0.620363321,-0.261610202
Alabama,01103,Morgan County,37392,11216,49991,26176,0.747974635,0.224360385,0.52361425
Alabama,01105,Perry County,1403,3823,5255,-2420,0.266983825,0.727497621,-0.460513796
Alabama,01107,Pickens County,5454,3972,9494,1482,0.574468085,0.418369497,0.156098588
Alabama,01109,Pike County,7681,5039,13025,2642,0.589712092,0.386871401,0.202840691
Alabama,01111,Randolph County,7697,2290,10130,5407,0.75982231,0.226061204,0.533761106
Alabama,01113,Russell County,9210,9577,19136,-367,0.481291806,0.500470318,-0.019178512
Alabama,01117,Shelby County,72846,22927,99208,49919,0.734275462,0.231100314,0.503175148
Alabama,01115,St. Clair County,31579,5550,37937,26029,0.832406358,0.146295174,0.686111184
Alabama,01119,Sumter County,1581,4739,6391,-3158,0.247379127,0.741511501,-0.494132374
Alabama,01121,Talladega County,20596,12108,33218,8488,0.620025287,0.364501174,0.255524113
Alabama,01123,Tallapoosa County,12967,5271,18504,7696,0.700767402,0.284857328,0.415910074
Alabama,01125,Tuscaloosa County,47701,31746,81708,15955,0.583798404,0.388529887,0.195268517
Alabama,01127,Walker County,24208,4486,29243,19722,0.827822043,0.153404233,0.67441781
Alabama,01129,Washington County,6031,2366,8492,3665,0.710197833,0.278615167,0.431582666
Alabama,01131,Wilcox County,1737,4329,6095,-2592,0.284987695,0.710254307,-0.425266612
Alabama,01133,Winston County,9225,871,10255,8354,0.89956119,0.084934178,0.814627012
Arkansas,05001,Arkansas County,3825,1939,6167,1886,0.620236744,0.314415437,0.305821307
Arkansas,05003,Ashley County,5338,2408,8027,2930,0.665005606,0.299987542,0.365018064
Arkansas,05005,Baxter County,14655,4163,19572,10492,0.748773758,0.212701819,0.536071939
Arkansas,05007,Benton County,60751,27894,94262,32857,0.644490887,0.295919883,0.348571004
Arkansas,05009,Boone County,12225,2925,15912,9300,0.768288084,0.183823529,0.584464555
Arkansas,05011,Bradley County,2163,1317,3617,846,0.5980094,0.364113907,0.233895493
Arkansas,05013,Calhoun County,1554,636,2250,918,0.690666667,0.282666667,0.408
Arkansas,05015,Carroll County,6773,3334,10656,3439,0.635604354,0.312875375,0.322728979
Arkansas,05017,Chicot County,1716,2350,4149,-634,0.413593637,0.566401543,-0.152807906
Arkansas,05019,Clark County,4398,3606,8365,792,0.525762104,0.431081889,0.094680215
Arkansas,05021,Clay County,3779,1999,5978,1780,0.632151221,0.334392774,0.297758447
Arkansas,05023,Cleburne County,9454,2101,11968,7353,0.78993984,0.175551471,0.614388369
Arkansas,05025,Cleveland County,2460,723,3299,1737,0.745680509,0.21915732,0.526523189
Arkansas,05027,Columbia County,5456,3140,8837,2316,0.617404096,0.355324205,0.262079891
Arkansas,05029,Conway County,4844,2655,7837,2189,0.618093658,0.338777593,0.279316065
Arkansas,05031,Craighead County,22798,10474,34968,12324,0.651967513,0.299531,0.352436513
Arkansas,05033,Crawford County,16655,4476,22155,12179,0.751749041,0.202031144,0.549717897
Arkansas,05035,Crittenden County,6953,8368,15798,-1415,0.440119002,0.529687302,-0.0895683
Arkansas,05037,Cross County,4577,1995,6831,2582,0.67003367,0.292050944,0.377982726
Arkansas,05039,Dallas County,1507,1165,2741,342,0.549799343,0.425027362,0.124771981
Arkansas,05041,Desha County,1915,2227,4226,-312,0.453147184,0.526975864,-0.07382868
Arkansas,05043,Drew County,3967,2364,6552,1603,0.60546398,0.360805861,0.244658119
Arkansas,05045,Faulkner County,29170,14525,46364,14645,0.629151928,0.313281857,0.315870071
Arkansas,05047,Franklin County,5034,1376,6698,3658,0.751567632,0.205434458,0.546133174
Arkansas,05049,Fulton County,3470,1067,4744,2403,0.731450253,0.224915683,0.50653457
Arkansas,05051,Garland County,26053,12283,40337,13770,0.645883432,0.304509507,0.341373925
Arkansas,05053,Grant County,5160,1407,6855,3753,0.75273523,0.205251641,0.547483589
Arkansas,05055,Greene County,10698,3056,14422,7642,0.741783386,0.211898488,0.529884898
Arkansas,05057,Hempstead County,4391,2371,6984,2020,0.628722795,0.339490263,0.289232532
Arkansas,05059,Hot Spring County,8153,3137,11815,5016,0.690055015,0.265509945,0.42454507
Arkansas,05061,Howard County,3155,1350,4634,1805,0.68083729,0.291324989,0.389512301
Arkansas,05063,Independence County,9925,2878,13443,7047,0.738302462,0.214089117,0.524213345
Arkansas,05065,Izard County,4042,1111,5396,2931,0.749073388,0.205893254,0.543180134
Arkansas,05067,Jackson County,3262,1583,5093,1679,0.640486943,0.310818771,0.329668172
Arkansas,05069,Jefferson County,9231,15721,25683,-6490,0.359420628,0.612116965,-0.252696337
Arkansas,05071,Johnson County,6072,2421,8997,3651,0.674891631,0.269089697,0.405801934
Arkansas,05073,Lafayette County,1750,1028,2835,722,0.617283951,0.362610229,0.254673722
Arkansas,05075,Lawrence County,4064,1263,5629,2801,0.721975484,0.224373779,0.497601705
Arkansas,05077,Lee County,1229,1735,3004,-506,0.409121172,0.577563249,-0.168442077
Arkansas,05079,Lincoln County,2455,1252,3814,1203,0.643681175,0.328264289,0.315416886
Arkansas,05081,Little River County,3604,1397,5192,2207,0.694144838,0.269067797,0.425077041
Arkansas,05083,Logan County,5737,1712,7839,4025,0.731853553,0.218395203,0.51345835
Arkansas,05085,Lonoke County,19902,5638,26766,14264,0.743555257,0.210640365,0.532914892
Arkansas,05087,Madison County,4917,1587,6782,3330,0.725007372,0.234001769,0.491005603
Arkansas,05089,Marion County,5077,1377,6718,3700,0.755730872,0.204971718,0.550759154
Arkansas,05091,Miller County,11293,4273,16015,7020,0.705151421,0.266812363,0.438339058
Arkansas,05093,Mississippi County,6988,5621,12995,1367,0.537745287,0.432550981,0.105194306
Arkansas,05095,Monroe County,1400,1298,2766,102,0.506146059,0.469269704,0.036876355
Arkansas,05097,Montgomery County,2573,735,3445,1838,0.746879536,0.213352685,0.533526851
Arkansas,05099,Nevada County,2001,1156,3233,845,0.618929787,0.357562635,0.261367152
Arkansas,05101,Newton County,2875,699,3731,2176,0.770570893,0.187349236,0.583221657
Arkansas,05103,Ouachita County,5347,4320,9881,1027,0.541139561,0.437202712,0.103936849
Arkansas,05105,Perry County,2979,1035,4213,1944,0.70709708,0.24566817,0.46142891
Arkansas,05107,Phillips County,2443,4292,6894,-1849,0.354366115,0.622570351,-0.268204236
Arkansas,05109,Pike County,3150,684,3956,2466,0.796258847,0.172901921,0.623356926
Arkansas,05111,Poinsett County,3149,1878,5283,1271,0.596062843,0.355479841,0.240583002
Arkansas,05113,Polk County,6606,1210,8121,5396,0.81344662,0.148996429,0.664450191
Arkansas,05115,Pope County,15694,4818,21545,10876,0.72842887,0.223624971,0.504803899
Arkansas,05117,Prairie County,2503,812,3404,1691,0.735311398,0.238542891,0.496768507
Arkansas,05119,Pulaski County,61182,89377,157728,-28195,0.387895618,0.566652719,-0.178757101
Arkansas,05121,Randolph County,4508,1425,6313,3083,0.714082053,0.225724695,0.488357358
Arkansas,05125,Saline County,35852,13247,51971,22605,0.68984626,0.254892151,0.434954109
Arkansas,05127,Scott County,2378,507,3017,1871,0.788200199,0.16804773,0.620152469
Arkansas,05129,Searcy County,2955,601,3698,2354,0.799080584,0.162520281,0.636560303
Arkansas,05131,Sebastian County,28769,12184,43557,16585,0.660490851,0.279725417,0.380765434
Arkansas,05133,Sevier County,3281,1075,4517,2206,0.726367058,0.237989816,0.488377242
Arkansas,05135,Sharp County,5405,1472,7190,3933,0.751738526,0.20472879,0.547009736
Arkansas,05123,St. Francis County,3195,4031,7412,-836,0.431057744,0.543847814,-0.11279007
Arkansas,05137,Stone County,4081,1189,5527,2892,0.738375249,0.215125746,0.523249503
Arkansas,05139,Union County,10201,5667,16338,4534,0.624372628,0.346860081,0.277512547
Arkansas,05141,Van Buren County,5382,1547,7111,3835,0.756855576,0.217550274,0.539305302
Arkansas,05143,Washington County,40418,32296,78153,8122,0.517165048,0.413240695,0.103924353
Arkansas,05145,White County,21038,5157,27451,15881,0.766383738,0.187862009,0.578521729
Arkansas,05147,Woodruff County,1344,1117,2550,227,0.527058824,0.438039216,0.089019608
Arkansas,05149,Yell County,4600,1472,6389,3128,0.719987478,0.230395993,0.489591485
Arizona,04001,Apache County,5315,12196,18659,-6881,0.284849134,0.653625596,-0.368776462
Arizona,04003,Cochise County,25036,15291,43147,9745,0.580248916,0.354393121,0.225855795
Arizona,04005,Coconino County,16573,25308,44929,-8735,0.368870885,0.563288744,-0.194417859
Arizona,04007,Gila County,13672,6746,21398,6926,0.638938219,0.315263109,0.32367511
Arizona,04009,Graham County,8025,3301,11939,4724,0.672166848,0.276488818,0.39567803
Arizona,04011,Greenlee County,1892,1092,3243,800,0.583410422,0.336725254,0.246685168
Arizona,04012,La Paz County,3381,1318,4931,2063,0.685662137,0.267288582,0.418373555
Arizona,04013,Maricopa County,590465,549040,1201934,41425,0.491262415,0.456797129,0.034465286
Arizona,04015,Mohave County,54656,16485,74189,38171,0.73671299,0.222202752,0.514510238
Arizona,04017,Navajo County,18165,15362,35409,2803,0.513005168,0.433844503,0.079160665
Arizona,04019,Pima County,147019,195649,360762,-48630,0.40752352,0.542321531,-0.134798011
Arizona,04021,Pinal County,53857,35737,93805,18120,0.574137839,0.380971164,0.193166675
Arizona,04023,Santa Cruz County,3650,10684,14926,-7034,0.244539729,0.715797936,-0.471258207
Arizona,04025,Yavapai County,58862,29705,92780,29157,0.634425523,0.320165984,0.314259539
Arizona,04027,Yuma County,20586,18336,40759,2250,0.505066366,0.449863834,0.055202532
California,06001,Alameda County,91189,486351,613195,-395162,0.148711258,0.793142475,-0.644431217
California,06003,Alpine County,211,318,575,-107,0.366956522,0.553043478,-0.186086956
California,06005,Amador County,10239,5904,17186,4335,0.595775631,0.343535436,0.252240195
California,06007,Butte County,42193,38676,87847,3517,0.480300978,0.440265462,0.040035516
California,06009,Calaveras County,13072,7738,22334,5334,0.585295961,0.34646727,0.238828691
California,06011,Colusa County,3551,2659,6594,892,0.538519867,0.403245375,0.135274492
California,06013,Contra Costa County,105819,286658,415972,-180839,0.254389719,0.689128114,-0.434738395
California,06015,Del Norte County,5134,3485,9361,1649,0.548445679,0.372289285,0.176156394
California,06017,El Dorado County,47633,35243,89228,12390,0.533834671,0.394976913,0.138857758
California,06019,Fresno County,113949,123660,250264,-9711,0.455315187,0.494118211,-0.038803024
California,06021,Glenn County,5788,3065,9379,2723,0.617123361,0.326793901,0.29032946
California,06023,Humboldt County,10883,19596,33636,-8713,0.323552147,0.582590082,-0.259037935
California,06025,Imperial County,11295,28467,41751,-17172,0.270532442,0.68182798,-0.411295538
California,06027,Inyo County,4248,3155,7996,1093,0.531265633,0.394572286,0.136693347
California,06029,Kern County,119164,86481,217725,32683,0.547314273,0.397202894,0.150111379
California,06031,Kings County,17446,12902,32250,4544,0.54096124,0.400062016,0.140899224
California,06033,Lake County,5752,6240,13045,-488,0.440935224,0.478344193,-0.037408969
California,06035,Lassen County,7574,2224,10422,5350,0.726731913,0.213394742,0.513337171
California,06037,Los Angeles County,620285,1893770,2652072,-1273485,0.233886938,0.714071865,-0.480184927
California,06039,Madera County,19221,13283,34263,5938,0.560984152,0.38767767,0.173306482
California,06041,Marin County,17531,86650,109941,-69119,0.159458255,0.788150008,-0.628691753
California,06043,Mariposa County,5185,3122,8877,2063,0.584093725,0.351695393,0.232398332
California,06045,Mendocino County,3571,6905,11435,-3334,0.312286839,0.603847836,-0.291560997
California,06047,Merced County,18486,21856,42523,-3370,0.434729441,0.513980669,-0.079251228
California,06049,Modoc County,2413,798,3359,1615,0.718368562,0.237570706,0.480797856
California,06051,Mono County,2080,2696,5154,-616,0.403570043,0.523088863,-0.11951882
California,06053,Monterey County,26378,64733,96676,-38355,0.272849518,0.669587074,-0.396737556
California,06055,Napa County,11946,26161,40393,-14215,0.295744312,0.647661724,-0.351917412
California,06057,Nevada County,14686,16199,33258,-1513,0.441577966,0.48707078,-0.045492814
California,06059,Orange County,472669,556544,1092116,-83875,0.432801094,0.509601544,-0.07680045
California,06061,Placer County,78977,61969,150532,17008,0.524652566,0.411666622,0.112985944
California,06063,Plumas County,5079,3224,8830,1855,0.575198188,0.365118913,0.210079275
California,06065,Riverside County,309514,339145,683612,-29631,0.452762678,0.496107441,-0.043344763
California,06067,Sacramento County,163024,273768,467526,-110744,0.348695046,0.585567434,-0.236872388
California,06069,San Benito County,6471,10050,17572,-3579,0.368256317,0.57193262,-0.203676303
California,06071,San Bernardino County,253962,312517,598783,-58555,0.424130278,0.521920295,-0.097790017
California,06073,San Diego County,386807,567243,1011651,-180436,0.382352214,0.560710166,-0.178357952
California,06075,San Francisco County,34493,312443,365295,-277950,0.094425054,0.855316936,-0.760891882
California,06077,San Joaquin County,68316,89791,166647,-21475,0.409944373,0.53880958,-0.128865207
California,06079,San Luis Obispo County,52672,63001,124575,-10329,0.422813566,0.505727473,-0.082913907
California,06081,San Mateo County,53731,219580,287499,-165849,0.186891085,0.763759178,-0.576868093
California,06083,Santa Barbara County,53740,100120,164224,-46380,0.32723597,0.609655105,-0.282419135
California,06085,Santa Clara County,137452,483472,659148,-346020,0.208529799,0.73348019,-0.524950391
California,06087,Santa Cruz County,20158,85185,113509,-65027,0.177589442,0.750469126,-0.572879684
California,06089,Shasta County,47587,20471,72554,27116,0.655883893,0.282148469,0.373735424
California,06091,Sierra County,1048,601,1804,447,0.580931264,0.333148559,0.247782705
California,06093,Siskiyou County,11212,7106,19836,4106,0.565234926,0.358237548,0.206997378
California,06095,Solano County,49595,97159,156067,-47564,0.317780184,0.622546727,-0.304766543
California,06097,Sonoma County,37421,116027,164060,-78606,0.22809338,0.707222967,-0.479129587
California,06099,Stanislaus County,72960,73939,156141,-979,0.467269968,0.473539941,-0.006269973
California,06101,Sutter County,16780,11831,30429,4949,0.551447632,0.38880673,0.162640902
California,06103,Tehama County,14981,6571,22875,8410,0.654907104,0.287256831,0.367650273
California,06105,Trinity County,2409,1876,4716,533,0.510814249,0.397794741,0.113019508
California,06107,Tulare County,50488,39099,94571,11389,0.533863447,0.413435408,0.120428039
California,06109,Tuolumne County,13486,8580,23472,4906,0.574556919,0.365541922,0.209014997
California,06111,Ventura County,118764,170489,307881,-51725,0.385746441,0.553749663,-0.168003222
California,06113,Yolo County,13178,34460,50623,-21282,0.260316457,0.680718251,-0.420401794
California,06115,Yuba County,12313,7234,21058,5079,0.584718397,0.343527401,0.241190996
Colorado,08001,Adams County,73807,86471,175125,-12664,0.421453248,0.493767309,-0.072314061
Colorado,08003,Alamosa County,3031,3168,6897,-137,0.439466435,0.459330144,-0.019863709
Colorado,08005,Arapahoe County,109638,148365,281658,-38727,0.389259314,0.526755853,-0.137496539
Colorado,08007,Archuleta County,4234,2489,7290,1745,0.58079561,0.341426612,0.239368998
Colorado,08009,Baca County,1716,278,2107,1438,0.814428097,0.131941149,0.682486948
Colorado,08011,Bent County,1166,581,1892,585,0.61627907,0.307082452,0.309196618
Colorado,08013,Boulder County,38766,124715,176735,-85949,0.219345348,0.705661018,-0.48631567
Colorado,8014,Broomfield County,14272,19530,37342,-5258,0.38219699,0.523003588,-0.140806598
Colorado,08015,Chaffee County,5283,4773,10999,510,0.480316392,0.433948541,0.046367851
Colorado,08017,Cheyenne County,905,127,1076,778,0.841078067,0.11802974,0.723048327
Colorado,08019,Clear Creek County,2426,2585,5532,-159,0.438539407,0.467281273,-0.028741866
Colorado,08021,Conejos County,1885,1753,3970,132,0.474811083,0.441561713,0.03324937
Colorado,08023,Costilla County,581,1109,1820,-528,0.319230769,0.609340659,-0.29010989
Colorado,08025,Crowley County,1069,336,1511,733,0.707478491,0.222369292,0.485109199
Colorado,08027,Custer County,2059,797,3064,1262,0.671997389,0.260117493,0.411879896
Colorado,08029,Delta County,11584,4048,16661,7536,0.695276394,0.242962607,0.452313787
Colorado,08031,Denver County,43637,174611,232291,-130974,0.187854889,0.751690767,-0.563835878
Colorado,08033,Dolores County,936,227,1230,709,0.76097561,0.184552846,0.576422764
Colorado,08035,Douglas County,100178,67045,182918,33133,0.547666167,0.366530358,0.181135809
Colorado,08037,Eagle County,8153,12652,22611,-4499,0.36057671,0.559550661,-0.198973951
Colorado,08039,Elbert County,11536,3056,15689,8480,0.735292243,0.194786156,0.540506087
Colorado,08041,El Paso County,176506,105807,313273,70699,0.563425511,0.337746949,0.225678562
Colorado,08043,Fremont County,15066,5275,21880,9791,0.68857404,0.241087751,0.447486289
Colorado,08045,Garfield County,13071,11205,26328,1866,0.496467639,0.425592525,0.070875114
Colorado,08047,Gilpin County,1564,1634,3574,-70,0.437604924,0.457190823,-0.019585899
Colorado,08049,Grand County,4467,3319,8513,1148,0.524726888,0.38987431,0.134852578
Colorado,08051,Gunnison County,3250,5068,9299,-1818,0.349499946,0.545004839,-0.195504893
Colorado,08053,Hinsdale County,339,197,589,142,0.575551783,0.334465195,0.241086588
Colorado,08055,Huerfano County,1875,1631,3772,244,0.497083775,0.432396607,0.064687168
Colorado,08057,Jackson County,628,171,862,457,0.728538283,0.19837587,0.530162413
Colorado,08059,Jefferson County,130233,151885,309529,-21652,0.420745714,0.490697156,-0.069951442
Colorado,08061,Kiowa County,726,91,853,635,0.851113716,0.106682298,0.744431418
Colorado,08063,Kit Carson County,2894,526,3613,2368,0.800996402,0.145585386,0.655411016
Colorado,08065,Lake County,1264,1600,3175,-336,0.398110236,0.503937008,-0.105826772
Colorado,08067,La Plata County,12471,15300,30722,-2829,0.405930603,0.498014452,-0.092083849
Colorado,08069,Larimer County,82624,92170,193897,-9546,0.426123148,0.475355472,-0.049232324
Colorado,08071,Las Animas County,3656,2614,6693,1042,0.546242343,0.390557299,0.155685044
Colorado,08073,Lincoln County,1873,399,2402,1474,0.779766861,0.166111574,0.613655287
Colorado,08075,Logan County,7272,1843,9702,5429,0.749536178,0.189960833,0.559575345
Colorado,08077,Mesa County,48129,20958,74876,27171,0.642782734,0.279902773,0.362879961
Colorado,08079,Mineral County,344,237,652,107,0.527607362,0.363496933,0.164110429
Colorado,08081,Moffat County,5293,874,6510,4419,0.813056836,0.134254992,0.678801844
Colorado,08083,Montezuma County,7771,3920,12706,3851,0.611600819,0.308515662,0.303085157
Colorado,08085,Montrose County,14303,5438,21070,8865,0.678832463,0.258092074,0.420740389
Colorado,08087,Morgan County,8104,3128,11888,4976,0.681695828,0.263122476,0.418573352
Colorado,08089,Otero County,2988,1719,5038,1269,0.593092497,0.341206828,0.251885669
Colorado,08091,Ouray County,1337,1690,3287,-353,0.406753879,0.514146638,-0.107392759
Colorado,08093,Park County,6053,3351,10245,2702,0.590824793,0.327086384,0.263738409
Colorado,08095,Phillips County,1791,436,2332,1355,0.768010292,0.186963979,0.581046313
Colorado,08097,Pitkin County,2522,7239,10387,-4717,0.242803504,0.696928853,-0.454125349
Colorado,08099,Prowers County,3508,1173,4978,2335,0.704700683,0.235636802,0.469063881
Colorado,08101,Pueblo County,27746,27945,60112,-199,0.461571733,0.46488222,-0.003310487
Colorado,08103,Rio Blanco County,2782,433,3436,2349,0.809662398,0.126018626,0.683643772
Colorado,08105,Rio Grande County,3060,1985,5488,1075,0.557580175,0.361698251,0.195881924
Colorado,08107,Routt County,5149,7487,13772,-2338,0.373874528,0.543639268,-0.16976474
Colorado,08109,Saguache County,1109,1345,2707,-236,0.409678611,0.496859993,-0.087181382
Colorado,08111,San Juan County,215,265,506,-50,0.424901186,0.523715415,-0.098814229
Colorado,08113,San Miguel County,1030,2960,4311,-1930,0.238923684,0.686615634,-0.44769195
Colorado,08115,Sedgwick County,1015,267,1364,748,0.744134897,0.195747801,0.548387096
Colorado,08117,Summit County,5064,9502,16061,-4438,0.315297927,0.591619451,-0.276321524
Colorado,08119,Teller County,9580,3547,14203,6033,0.674505386,0.249735971,0.424769415
Colorado,08121,Washington County,2284,289,2708,1995,0.843426883,0.106720827,0.736706056
Colorado,08123,Weld County,75882,45869,133790,30013,0.567172434,0.342843262,0.224329172
Colorado,08125,Yuma County,3755,701,4664,3054,0.805102916,0.150300172,0.654802744
Connecticut,09001,Fairfield County,155457,238723,410279,-83266,0.378905574,0.581855274,-0.2029497
Connecticut,09003,Hartford County,147912,233789,399219,-85877,0.370503408,0.585615915,-0.215112507
Connecticut,09005,Litchfield County,53376,39836,97434,13540,0.547816984,0.40885112,0.138965864
Connecticut,09007,Middlesex County,38847,45306,88402,-6459,0.439435759,0.512499717,-0.073063958
Connecticut,09009,New Haven County,158373,203601,375909,-45228,0.421306752,0.541623106,-0.120316354
Connecticut,09011,New London County,54574,62951,124527,-8377,0.438250339,0.505520891,-0.067270552
Connecticut,09013,Tolland County,33989,38450,77069,-4461,0.441020384,0.49890358,-0.057883196
Connecticut,09015,Windham County,25738,21776,50703,3962,0.507622823,0.42948149,0.078141333
District of Columbia,11001,District of Columbia,11553,260223,280272,-248670,0.041220671,0.928465919,-0.887245248
Delaware,10001,Kent County,36989,33347,74253,3642,0.498148223,0.4490997,0.049048523
Delaware,10003,New Castle County,85507,162905,261468,-77398,0.327026634,0.623039913,-0.296013279
Delaware,10005,Sussex County,62607,39329,105814,23278,0.591670289,0.371680496,0.219989793
Florida,12001,Alachua County,46584,75370,127827,-28786,0.36443005,0.58962504,-0.22519499
Florida,12003,Baker County,10294,2112,12634,8182,0.814785499,0.167167959,0.64761754
Florida,12005,Bay County,62010,21689,87151,40321,0.711523677,0.248866909,0.462656768
Florida,12007,Bradford County,8913,2924,12098,5989,0.736733344,0.241692842,0.495040502
Florida,12009,Brevard County,181620,119525,314337,62095,0.577787534,0.380244769,0.197542765
Florida,12011,Broward County,258521,546956,822837,-288435,0.314182517,0.664719744,-0.350537227
Florida,12013,Calhoun County,4647,1236,6067,3411,0.765946926,0.20372507,0.562221856
Florida,12015,Charlotte County,60196,33421,96323,26775,0.624939007,0.346968014,0.277970993
Florida,12017,Citrus County,54377,22765,79590,31612,0.683213972,0.286028396,0.397185576
Florida,12019,Clay County,74898,27768,106363,47130,0.704173444,0.261068229,0.443105215
Florida,12021,Collier County,105297,60941,170505,44356,0.617559602,0.357414739,0.260144863
Florida,12023,Columbia County,20359,7599,28696,12760,0.709471703,0.264810427,0.444661276
Florida,12027,DeSoto County,6744,3761,10761,2983,0.626707555,0.349502834,0.277204721
Florida,12029,Dixie County,5822,1270,7202,4552,0.808386559,0.176339906,0.632046653
Florida,12031,Duval County,210061,203627,428734,6434,0.489956477,0.474949502,0.015006975
Florida,12033,Escambia County,88370,57114,151609,31256,0.582880964,0.37671906,0.206161904
Florida,12035,Flagler County,33804,21985,57413,11819,0.588786512,0.382927212,0.2058593
Florida,12037,Franklin County,4119,1738,6003,2381,0.686156922,0.289521906,0.396635016
Florida,12039,Gadsden County,6721,14994,22079,-8273,0.304406902,0.679106844,-0.374699942
Florida,12041,Gilchrist County,6740,1457,8418,5283,0.800665241,0.173081492,0.627583749
Florida,12043,Glades County,2996,1271,4355,1725,0.687944891,0.29184845,0.396096441
Florida,12045,Gulf County,5320,1715,7279,3605,0.730869625,0.235609287,0.495260338
Florida,12047,Hamilton County,3439,1899,5451,1540,0.630893414,0.348376445,0.282516969
Florida,12049,Hardee County,5238,2147,7577,3091,0.691302626,0.283357529,0.407945097
Florida,12051,Hendry County,6192,4610,11106,1582,0.557536467,0.415090942,0.142445525
Florida,12053,Hernando County,59029,31818,93878,27211,0.628784167,0.338929249,0.289854918
Florida,12055,Highlands County,29509,14901,45589,14608,0.647283336,0.326855162,0.320428174
Florida,12057,Hillsborough County,265928,306422,595072,-40494,0.446883738,0.514932647,-0.068048909
Florida,12059,Holmes County,7476,852,8506,6624,0.878909005,0.10016459,0.778744415
Florida,12061,Indian River County,48564,28997,79897,19567,0.607832584,0.362929772,0.244902812
Florida,12063,Jackson County,14231,6383,20997,7848,0.67776349,0.303995809,0.373767681
Florida,12065,Jefferson County,3930,3537,7641,393,0.514330585,0.462897527,0.051433058
Florida,12067,Lafayette County,2795,515,3375,2280,0.828148148,0.152592593,0.675555555
Florida,12069,Lake County,101888,62597,169898,39291,0.599700997,0.36843871,0.231262287
Florida,12071,Lee County,191141,124725,325797,66416,0.586687416,0.382830413,0.203857003
Florida,12073,Leon County,53777,91936,151925,-38159,0.353970709,0.605140694,-0.251169985
Florida,12075,Levy County,13758,5091,19367,8667,0.710383642,0.26286983,0.447513812
Florida,12077,Liberty County,2542,651,3295,1891,0.771471927,0.197572079,0.573899848
Florida,12079,Madison County,4849,3526,8503,1323,0.570269317,0.414677173,0.155592144
Florida,12081,Manatee County,101681,71066,178521,30615,0.569574448,0.398082018,0.17149243
Florida,12083,Marion County,107710,61958,174485,45752,0.617302347,0.355090695,0.262211652
Florida,12085,Martin County,53182,30158,85741,23024,0.620263351,0.35173371,0.268529641
Florida,12086,Miami-Dade County,333666,623006,978670,-289340,0.340938212,0.636584344,-0.295646132
Florida,12087,Monroe County,21885,18949,42434,2936,0.515742094,0.446552293,0.069189801
Florida,12089,Nassau County,34221,10849,46537,23372,0.735350366,0.23312633,0.502224036
Florida,12091,Okaloosa County,71788,23711,100657,48077,0.713194313,0.235562355,0.477631958
Florida,12093,Okeechobee County,9342,3953,13632,5389,0.685299296,0.28997946,0.395319836
Florida,12095,Orange County,195091,329579,545800,-134488,0.357440454,0.603845731,-0.246405277
Florida,12097,Osceola County,50252,85287,139981,-35035,0.358991577,0.609275545,-0.250283968
Florida,12099,Palm Beach County,270762,371411,657235,-100649,0.411971365,0.565111414,-0.153140049
Florida,12101,Pasco County,141943,89998,240814,51945,0.589430017,0.373724119,0.215705898
Florida,12103,Pinellas County,238746,233327,491520,5419,0.48572998,0.474704997,0.011024983
Florida,12105,Polk County,157216,117182,283828,40034,0.553912933,0.41286272,0.141050213
Florida,12107,Putnam County,21873,9920,32652,11953,0.669882396,0.303809874,0.366072522
Florida,12113,Santa Rosa County,65126,18398,87432,46728,0.744876018,0.210426389,0.534449629
Florida,12115,Sarasota County,124098,97676,228509,26422,0.543077078,0.427449247,0.115627831
Florida,12117,Seminole County,109265,105611,224377,3654,0.48697059,0.470685498,0.016285092
Florida,12109,St. Johns County,88633,43037,136392,45596,0.649840167,0.315539035,0.334301132
Florida,12111,St. Lucie County,70248,66812,140731,3436,0.499165074,0.4747497,0.024415374
Florida,12119,Sumter County,52722,22631,76649,30091,0.687836762,0.295254994,0.392581768
Florida,12121,Suwannee County,14281,3955,18675,10326,0.764712182,0.211780455,0.552931727
Florida,12123,Taylor County,6923,2149,9279,4774,0.746093329,0.231598233,0.514495096
Florida,12125,Union County,4567,1014,5693,3553,0.802213244,0.178113473,0.624099771
Florida,12127,Volusia County,142763,108793,260304,33970,0.5484472,0.41794594,0.13050126
Florida,12129,Wakulla County,10507,4348,15344,6159,0.684762774,0.283368092,0.401394682
Florida,12131,Walton County,25695,6861,33559,18834,0.765666438,0.204445901,0.561220537
Florida,12133,Washington County,8630,2261,11144,6369,0.774407753,0.202889447,0.571518306
Georgia,13001,Appling County,5492,1434,7003,4058,0.784235328,0.204769385,0.579465943
Georgia,13003,Atkinson County,1873,696,2604,1177,0.719278034,0.267281106,0.451996928
Georgia,13005,Bacon County,3356,607,4010,2749,0.836907731,0.151371571,0.68553616
Georgia,13007,Baker County,775,650,1440,125,0.538194444,0.451388889,0.086805555
Georgia,13009,Baldwin County,7691,7965,16075,-274,0.47844479,0.495489891,-0.017045101
Georgia,13011,Banks County,6130,684,6946,5446,0.882522315,0.098473942,0.784048373
Georgia,13013,Barrow County,21105,6580,28828,14525,0.732100735,0.228250312,0.503850423
Georgia,13015,Bartow County,29879,8204,39263,21675,0.760996358,0.208949902,0.552046456
Georgia,13017,Ben Hill County,3734,2098,5923,1636,0.630423772,0.354212392,0.27621138
Georgia,13019,Berrien County,5408,1041,6563,4367,0.824013409,0.158616486,0.665396923
Georgia,13021,Bibb County,22589,34383,58327,-11794,0.387282048,0.589486859,-0.202204811
Georgia,13023,Bleckley County,3717,1094,4934,2623,0.753344143,0.221726794,0.531617349
Georgia,13025,Brantley County,5561,619,6285,4942,0.884805091,0.098488465,0.786316626
Georgia,13027,Brooks County,3679,2504,6268,1175,0.586949585,0.39948947,0.187460115
Georgia,13029,Bryan County,10513,4010,15063,6503,0.697935338,0.266215229,0.431720109
Georgia,13031,Bulloch County,14476,8812,24151,5664,0.59939547,0.36487102,0.23452445
Georgia,13033,Burke County,4491,4730,9350,-239,0.480320856,0.505882353,-0.025561497
Georgia,13035,Butts County,6717,2566,9477,4151,0.708768598,0.270760789,0.438007809
Georgia,13037,Calhoun County,829,1178,2023,-349,0.409787444,0.58230351,-0.172516066
Georgia,13039,Camden County,12287,5914,18825,6373,0.652695883,0.314156707,0.338539176
Georgia,13043,Candler County,2661,1023,3757,1638,0.708277881,0.272291722,0.435986159
Georgia,13045,Carroll County,29983,12422,43744,17561,0.685419715,0.283970373,0.401449342
Georgia,13047,Catoosa County,20860,4769,26510,16091,0.786872878,0.179894379,0.606978499
Georgia,13049,Charlton County,2950,1004,4008,1946,0.736027944,0.250499002,0.485528942
Georgia,13051,Chatham County,43649,58998,106013,-15349,0.411732523,0.556516654,-0.144784131
Georgia,13053,Chattahoochee County,746,593,1384,153,0.539017341,0.428468208,0.110549133
Georgia,13055,Chattooga County,6457,1612,8246,4845,0.783046325,0.195488722,0.587557603
Georgia,13057,Cherokee County,80611,25203,110825,55408,0.727371983,0.227412587,0.499959396
Georgia,13059,Clarke County,12691,29514,44221,-16823,0.286990344,0.667420456,-0.380430112
Georgia,13061,Clay County,566,697,1271,-131,0.445318647,0.548387097,-0.10306845
Georgia,13063,Clayton County,11740,75908,89236,-64168,0.131561253,0.850643238,-0.719081985
Georgia,13065,Clinch County,1724,685,2443,1039,0.705689726,0.280392959,0.425296767
Georgia,13067,Cobb County,152602,159416,326424,-6814,0.467496263,0.488370953,-0.02087469
Georgia,13069,Coffee County,9575,4090,13896,5485,0.689047208,0.294329303,0.394717905
Georgia,13071,Colquitt County,9892,3460,13592,6432,0.727781048,0.254561507,0.473219541
Georgia,13073,Columbia County,43060,18863,64190,24197,0.670821,0.293861972,0.376959028
Georgia,13075,Cook County,4175,1752,6038,2423,0.691454124,0.290162305,0.401291819
Georgia,13077,Coweta County,42513,16572,61315,25941,0.693353992,0.270276441,0.423077551
Georgia,13079,Crawford County,3632,1419,5157,2213,0.704285437,0.275159977,0.42912546
Georgia,13081,Crisp County,4539,2835,7500,1704,0.6052,0.378,0.2272
Georgia,13083,Dade County,5047,965,6238,4082,0.809073421,0.154697018,0.654376403
Georgia,13085,Dawson County,9880,1444,11680,8436,0.845890411,0.123630137,0.722260274
Georgia,13087,Decatur County,6009,4104,10238,1905,0.586931041,0.400859543,0.186071498
Georgia,13089,DeKalb County,47531,239131,295871,-191600,0.160647715,0.808227234,-0.647579519
Georgia,13091,Dodge County,5021,1836,6995,3185,0.717798427,0.262473195,0.455325232
Georgia,13093,Dooly County,1941,1860,3836,81,0.505995829,0.484880083,0.021115746
Georgia,13095,Dougherty County,10227,23224,33925,-12997,0.301459101,0.684568902,-0.383109801
Georgia,13097,Douglas County,24803,30971,57365,-6168,0.432371655,0.539893663,-0.107522008
Georgia,13099,Early County,2552,2165,4782,387,0.533667921,0.45273944,0.080928481
Georgia,13101,Echols County,1006,156,1175,850,0.856170213,0.132765957,0.723404256
Georgia,13103,Effingham County,17865,4851,23395,13014,0.763624706,0.207351998,0.556272708
Georgia,13105,Elbert County,5269,2507,7912,2762,0.665950455,0.316860465,0.34908999
Georgia,13107,Emanuel County,5330,2433,7838,2897,0.680020413,0.310410819,0.369609594
Georgia,13109,Evans County,2404,1130,3602,1274,0.667406996,0.313714603,0.353692393
Georgia,13111,Fannin County,9622,1920,11764,7702,0.817919075,0.163209793,0.654709282
Georgia,13113,Fayette County,35034,23255,60387,11779,0.580157981,0.385099442,0.195058539
Georgia,13115,Floyd County,24045,9127,34250,14918,0.702043796,0.266481752,0.435562044
Georgia,13117,Forsyth County,69801,23427,97314,46374,0.717276034,0.240736174,0.47653986
Georgia,13119,Franklin County,7054,1243,8474,5811,0.832428605,0.146683975,0.68574463
Georgia,13121,Fulton County,110372,281875,407173,-171503,0.271069054,0.692273309,-0.421204255
Georgia,13123,Gilmer County,10465,1955,12713,8510,0.82317313,0.153779596,0.669393534
Georgia,13125,Glascock County,1235,138,1390,1097,0.888489209,0.099280576,0.789208633
Georgia,13127,Glynn County,21482,11738,34041,9744,0.631062542,0.344819482,0.28624306
Georgia,13129,Gordon County,15171,3176,18850,11995,0.804827586,0.168488064,0.636339522
Georgia,13131,Grady County,6047,3005,9187,3042,0.658212692,0.327092631,0.331120061
Georgia,13133,Greene County,5488,3194,8831,2294,0.621447175,0.361680444,0.259766731
Georgia,13135,Gwinnett County,146463,165063,323931,-18600,0.452142586,0.509562222,-0.057419636
Georgia,13137,Habersham County,13184,2483,16128,10701,0.817460317,0.153955853,0.663504464
Georgia,13139,Hall County,51681,16153,70133,35528,0.73689989,0.230319536,0.506580354
Georgia,13141,Hancock County,841,2695,3572,-1854,0.235442329,0.754479283,-0.519036954
Georgia,13143,Haralson County,9579,1474,11317,8105,0.846425731,0.130246532,0.716179199
Georgia,13145,Harris County,11931,4082,16392,7849,0.727855051,0.249023914,0.478831137
Georgia,13147,Hart County,7285,2583,10077,4702,0.722933413,0.256326288,0.466607125
Georgia,13149,Heard County,3370,743,4206,2627,0.801236329,0.176652401,0.624583928
Georgia,13151,Henry County,45641,49902,98037,-4261,0.465548721,0.509011904,-0.043463183
Georgia,13153,Houston County,35351,22460,59559,12891,0.593545896,0.377105055,0.216440841
Georgia,13155,Irwin County,2711,890,3659,1821,0.740912818,0.243235857,0.497676961
Georgia,13157,Jackson County,21754,4469,27057,17285,0.804006357,0.165169827,0.63883653
Georgia,13159,Jasper County,4353,1544,6016,2809,0.723570479,0.256648936,0.466921543
Georgia,13161,Jeff Davis County,4102,901,5089,3201,0.80605227,0.177048536,0.629003734
Georgia,13163,Jefferson County,3057,3809,6934,-752,0.44087107,0.549322181,-0.108451111
Georgia,13165,Jenkins County,1892,1108,3034,784,0.623599209,0.365194463,0.258404746
Georgia,13167,Johnson County,2519,1136,3682,1383,0.684139055,0.308527974,0.375611081
Georgia,13169,Jones County,8304,3960,12524,4344,0.66304695,0.31619291,0.34685404
Georgia,13171,Lamar County,5183,2267,7575,2916,0.684224422,0.299273927,0.384950495
Georgia,13173,Lanier County,1984,805,2861,1179,0.693463824,0.28137015,0.412093674
Georgia,13175,Laurens County,12401,6737,19448,5664,0.637649116,0.346410942,0.291238174
Georgia,13177,Lee County,10641,3166,14106,7475,0.754359847,0.224443499,0.529916348
Georgia,13179,Liberty County,6125,9531,16082,-3406,0.380860589,0.592650168,-0.211789579
Georgia,13181,Lincoln County,2759,1271,4100,1488,0.672926829,0.31,0.362926829
Georgia,13183,Long County,2623,1356,4109,1267,0.638354831,0.330007301,0.30834753
Georgia,13185,Lowndes County,21308,14614,36813,6694,0.578817266,0.396979328,0.181837938
Georgia,13187,Lumpkin County,9613,2216,12324,7397,0.78002272,0.179811749,0.600210971
Georgia,13193,Macon County,1540,2705,4287,-1165,0.359225566,0.630977373,-0.271751807
Georgia,13195,Madison County,9195,2423,11945,6772,0.76977815,0.202846379,0.566931771
Georgia,13197,Marion County,1921,1213,3183,708,0.603518693,0.381087025,0.222431668
Georgia,13189,McDuffie County,5432,3699,9268,1733,0.586102719,0.399115235,0.186987484
Georgia,13191,McIntosh County,3482,2298,5893,1184,0.590870524,0.389954183,0.200916341
Georgia,13199,Meriwether County,5216,3800,9181,1416,0.568129833,0.413898268,0.154231565
Georgia,13201,Miller County,1888,622,2540,1266,0.743307087,0.24488189,0.498425197
Georgia,13205,Mitchell County,4272,3492,7857,780,0.543718977,0.444444444,0.099274533
Georgia,13207,Monroe County,8821,3570,12675,5251,0.695936884,0.281656805,0.414280079
Georgia,13209,Montgomery County,2668,847,3560,1821,0.749438202,0.237921348,0.511516854
Georgia,13211,Morgan County,6559,2658,9435,3901,0.69517753,0.281717011,0.413460519
Georgia,13213,Murray County,10340,1799,12422,8541,0.832394139,0.1448237,0.687570439
Georgia,13215,Muscogee County,26901,39602,68320,-12701,0.39375,0.579654567,-0.185904567
Georgia,13217,Newton County,20907,21936,43787,-1029,0.477470482,0.500970608,-0.023500126
Georgia,13219,Oconee County,12885,5253,19030,7632,0.677088807,0.276037835,0.401050972
Georgia,13221,Oglethorpe County,4622,1829,6650,2793,0.695037594,0.275037594,0.42
Georgia,13223,Paulding County,44646,18004,64601,26642,0.691103853,0.278695376,0.412408477
Georgia,13225,Peach County,5405,5083,10699,322,0.505187401,0.47509113,0.030096271
Georgia,13227,Pickens County,11651,1977,13982,9674,0.833285653,0.141396081,0.691889572
Georgia,13229,Pierce County,6301,903,7297,5398,0.86350555,0.123749486,0.739756064
Georgia,13231,Pike County,7273,1239,8675,6034,0.838386167,0.142824207,0.69556196
Georgia,13233,Polk County,11006,2863,14158,8143,0.777369685,0.202217827,0.575151858
Georgia,13235,Pulaski County,2436,1104,3598,1332,0.677042802,0.306837132,0.37020567
Georgia,13237,Putnam County,6516,2745,9431,3771,0.690912947,0.291061393,0.399851554
Georgia,13239,Quitman County,575,461,1044,114,0.550766284,0.441570881,0.109195403
Georgia,13241,Rabun County,6287,1443,7949,4844,0.790917096,0.181532268,0.609384828
Georgia,13243,Randolph County,1270,1597,2895,-327,0.438687392,0.55164076,-0.112953368
Georgia,13245,Richmond County,24441,48707,74952,-24266,0.326088697,0.649842566,-0.323753869
Georgia,13247,Rockdale County,13463,23206,37589,-9743,0.358163292,0.617361462,-0.25919817
Georgia,13249,Schley County,1472,401,1909,1071,0.771084337,0.210057622,0.561026715
Georgia,13251,Screven County,3305,2300,5699,1005,0.579926303,0.403579575,0.176346728
Georgia,13253,Seminole County,2343,1186,3577,1157,0.655018172,0.331562762,0.32345541
Georgia,13255,Spalding County,15636,9347,25940,6289,0.602775636,0.360331534,0.242444102
Georgia,13257,Stephens County,7682,1835,9760,5847,0.787090164,0.188012295,0.599077869
Georgia,13259,Stewart County,805,1220,2053,-415,0.392109109,0.594252314,-0.202143205
Georgia,13261,Sumter County,5275,5520,10973,-245,0.480725417,0.503052948,-0.022327531
Georgia,13263,Talbot County,1196,2001,3243,-805,0.368794326,0.617021277,-0.248226951
Georgia,13265,Taliaferro County,349,545,897,-196,0.389074693,0.607580825,-0.218506132
Georgia,13267,Tattnall County,5092,1678,6879,3414,0.74022387,0.243930804,0.496293066
Georgia,13269,Taylor County,2062,1295,3402,767,0.606114051,0.380658436,0.225455615
Georgia,13271,Telfair County,2449,1313,3794,1136,0.645492884,0.346072746,0.299420138
Georgia,13273,Terrell County,1872,2267,4179,-395,0.447954056,0.542474276,-0.09452022
Georgia,13275,Thomas County,11225,7138,18730,4087,0.599305926,0.38109984,0.218206086
Georgia,13277,Tift County,8680,3892,12796,4788,0.67833698,0.304157549,0.374179431
Georgia,13279,Toombs County,6612,2338,9108,4274,0.725955204,0.256697409,0.469257795
Georgia,13281,Towns County,5377,1206,6726,4171,0.799435028,0.179304193,0.620130835
Georgia,13283,Treutlen County,1808,860,2700,948,0.66962963,0.318518519,0.351111111
Georgia,13285,Troup County,15643,9597,25793,6046,0.606482379,0.372077695,0.234404684
Georgia,13287,Turner County,2094,1243,3390,851,0.617699115,0.366666667,0.251032448
Georgia,13289,Twiggs County,2034,1970,4053,64,0.501850481,0.486059709,0.015790772
Georgia,13291,Union County,9849,1962,12039,7887,0.818091204,0.162970346,0.655120858
Georgia,13293,Upson County,7288,3471,10924,3817,0.667154888,0.317740754,0.349414134
Georgia,13295,Walker County,18938,4213,23939,14725,0.791094031,0.175988972,0.615105059
Georgia,13297,Walton County,31093,8279,40425,22814,0.769152752,0.204799011,0.564353741
Georgia,13299,Ware County,8508,3436,12150,5072,0.700246914,0.282798354,0.41744856
Georgia,13301,Warren County,991,1313,2332,-322,0.424957118,0.563036021,-0.138078903
Georgia,13303,Washington County,4138,4187,8422,-49,0.491332225,0.497150321,-0.005818096
Georgia,13305,Wayne County,8147,2039,10376,6108,0.785177332,0.19651118,0.588666152
Georgia,13307,Webster County,630,471,1114,159,0.565529623,0.422800718,0.142728905
Georgia,13309,Wheeler County,1421,646,2102,775,0.676022835,0.307326356,0.368696479
Georgia,13311,White County,9751,1672,11771,8079,0.82839181,0.142044006,0.686347804
Georgia,13313,Whitfield County,21514,7925,30362,13589,0.708583097,0.261017061,0.447566036
Georgia,13315,Wilcox County,2096,852,2973,1244,0.705011773,0.286579213,0.41843256
Georgia,13317,Wilkes County,2569,1844,4470,725,0.574720358,0.412527964,0.162192394
Georgia,13319,Wilkinson County,2332,1893,4276,439,0.545369504,0.442703461,0.102666043
Georgia,13321,Worth County,6144,2015,8266,4129,0.743285749,0.243769659,0.49951609
Hawaii,15001,Hawaii County,17500,41258,64865,-23758,0.269791105,0.636059508,-0.366268403
Hawaii,15003,Honolulu County,90296,175634,285683,-85338,0.31607061,0.614786319,-0.298715709
Hawaii,15007,Kauai County,7574,16456,26335,-8882,0.287602051,0.624871844,-0.337269793
Hawaii,15009,Maui County,13445,33479,51942,-20034,0.258846406,0.64454584,-0.385699434
Iowa,19001,Adair County,2456,1127,3759,1329,0.653365257,0.29981378,0.353551477
Iowa,19003,Adams County,1393,565,2082,828,0.669068204,0.271373679,0.397694525
Iowa,19005,Allamakee County,4072,2409,6837,1663,0.595582858,0.352347521,0.243235337
Iowa,19007,Appanoose County,4031,1813,6096,2218,0.661253281,0.297408136,0.363845145
Iowa,19009,Audubon County,2135,1079,3379,1056,0.631843741,0.319325244,0.312518497
Iowa,19011,Benton County,8226,4672,13690,3554,0.600876552,0.341271001,0.259605551
Iowa,19013,Black Hawk County,27382,32006,63221,-4624,0.433115579,0.506255833,-0.073140254
Iowa,19015,Boone County,7458,5517,13984,1941,0.533323799,0.394522311,0.138801488
Iowa,19017,Bremer County,7199,5349,13350,1850,0.539250936,0.400674157,0.138576779
Iowa,19019,Buchanan County,5504,3966,10137,1538,0.542961428,0.391240012,0.151721416
Iowa,19021,Buena Vista County,4895,2851,8179,2044,0.598483922,0.34857562,0.249908302
Iowa,19023,Butler County,4918,2163,7457,2755,0.65951455,0.290063028,0.369451522
Iowa,19025,Calhoun County,3466,1396,5105,2070,0.678942214,0.273457395,0.405484819
Iowa,19027,Carroll County,6627,3305,10435,3322,0.635074269,0.316722568,0.318351701
Iowa,19029,Cass County,4755,1946,7055,2809,0.673990078,0.275832743,0.398157335
Iowa,19031,Cedar County,5275,3578,9386,1697,0.562007245,0.381206052,0.180801193
Iowa,19033,Cerro Gordo County,11583,9840,22633,1743,0.511774842,0.434763399,0.077011443
Iowa,19035,Cherokee County,4188,1676,6186,2512,0.677012609,0.270934368,0.406078241
Iowa,19037,Chickasaw County,3739,2264,6367,1475,0.587246741,0.355583477,0.231663264
Iowa,19039,Clarke County,2706,1463,4405,1243,0.61430193,0.332122588,0.282179342
Iowa,19041,Clay County,5870,2246,8542,3624,0.687192695,0.262936081,0.424256614
Iowa,19043,Clayton County,5309,3236,9098,2073,0.583534843,0.355682568,0.227852275
Iowa,19045,Clinton County,11249,10079,22748,1170,0.494505011,0.443071918,0.051433093
Iowa,19047,Crawford County,4608,1985,6862,2623,0.671524337,0.289274264,0.382250073
Iowa,19049,Dallas County,19288,15662,37617,3626,0.512746896,0.416354308,0.096392588
Iowa,19051,Davis County,2721,976,3858,1745,0.705287714,0.252980819,0.452306895
Iowa,19053,Decatur County,2296,1201,3703,1095,0.620037807,0.324331623,0.295706184
Iowa,19055,Delaware County,5688,2956,9165,2732,0.620621931,0.322531369,0.298090562
Iowa,19057,Des Moines County,9479,8178,18713,1301,0.506546251,0.437022391,0.06952386
Iowa,19059,Dickinson County,6743,3051,10247,3692,0.658046257,0.297745682,0.360300575
Iowa,19061,Dubuque County,23384,22774,49037,610,0.476864409,0.464424822,0.012439587
Iowa,19063,Emmet County,3121,1356,4707,1765,0.663055024,0.288081581,0.374973443
Iowa,19065,Fayette County,5591,3666,9813,1925,0.569754407,0.373586059,0.196168348
Iowa,19067,Floyd County,4371,3177,7985,1194,0.547401378,0.397871008,0.14953037
Iowa,19069,Franklin County,3153,1490,4915,1663,0.641505595,0.303153611,0.338351984
Iowa,19071,Fremont County,2401,959,3554,1442,0.675576815,0.269836804,0.405740011
Iowa,19073,Greene County,2819,1688,4762,1131,0.59197816,0.354472911,0.237505249
Iowa,19075,Grundy County,4516,1847,6766,2669,0.667454922,0.27298256,0.394472362
Iowa,19077,Guthrie County,3603,1720,5654,1883,0.637247966,0.304209409,0.333038557
Iowa,19079,Hamilton County,4450,2715,7589,1735,0.586375016,0.357754645,0.228620371
Iowa,19081,Hancock County,3972,1582,5815,2390,0.683061049,0.27205503,0.411006019
Iowa,19083,Hardin County,5231,2774,8423,2457,0.621037635,0.329336341,0.291701294
Iowa,19085,Harrison County,4892,2123,7378,2769,0.663052318,0.287747357,0.375304961
Iowa,19087,Henry County,5764,2897,9286,2867,0.620719362,0.311975016,0.308744346
Iowa,19089,Howard County,2611,1674,4507,937,0.579321056,0.371422232,0.207898824
Iowa,19091,Humboldt County,3564,1251,5033,2313,0.708126366,0.248559507,0.459566859
Iowa,19093,Ida County,2655,792,3590,1863,0.739554318,0.220612813,0.518941505
Iowa,19095,Iowa County,5193,3070,8789,2123,0.590852202,0.349300262,0.24155194
Iowa,19097,Jackson County,5821,3837,10204,1984,0.570462564,0.376029008,0.194433556
Iowa,19099,Jasper County,10556,7108,18776,3448,0.562207073,0.378568385,0.183638688
Iowa,19101,Jefferson County,3738,3702,8001,36,0.467191601,0.462692163,0.004499438
Iowa,19103,Johnson County,20993,49942,75637,-28949,0.277549348,0.66028531,-0.382735962
Iowa,19105,Jones County,5718,3779,10011,1939,0.571171711,0.377484767,0.193686944
Iowa,19107,Keokuk County,3385,1265,4858,2120,0.696788802,0.260395224,0.436393578
Iowa,19109,Kossuth County,5637,2529,8505,3108,0.662786596,0.297354497,0.365432099
Iowa,19111,Lee County,8762,6195,15893,2567,0.551311898,0.389794249,0.161517649
Iowa,19113,Linn County,48183,58481,114664,-10298,0.420210354,0.510020582,-0.089810228
Iowa,19115,Louisa County,3060,1643,4943,1417,0.619057253,0.332389237,0.286668016
Iowa,19117,Lucas County,2873,1236,4297,1637,0.668606004,0.287642541,0.380963463
Iowa,19119,Lyon County,5188,917,6336,4271,0.818813131,0.144728535,0.674084596
Iowa,19121,Madison County,5336,2666,8523,2670,0.626070632,0.312800657,0.313269975
Iowa,19123,Mahaska County,7404,2606,10494,4798,0.705546026,0.24833238,0.457213646
Iowa,19125,Marion County,10940,5469,17554,5471,0.623219779,0.311552922,0.311666857
Iowa,19127,Marshall County,9125,7623,17700,1502,0.515536723,0.430677966,0.084858757
Iowa,19129,Mills County,5050,2080,7608,2970,0.663774974,0.273396425,0.390378549
Iowa,19131,Mitchell County,3180,1879,5360,1301,0.593283582,0.350559701,0.242723881
Iowa,19133,Monona County,3115,1244,4525,1871,0.68839779,0.274917127,0.413480663
Iowa,19135,Monroe County,2635,1053,3844,1582,0.685483871,0.273933403,0.411550468
Iowa,19137,Montgomery County,3431,1312,4998,2119,0.68647459,0.262505002,0.423969588
Iowa,19139,Muscatine County,9549,8284,19086,1265,0.500314367,0.434035419,0.066278948
Iowa,19141,O'Brien County,5735,1314,7348,4421,0.780484486,0.17882417,0.601660316
Iowa,19143,Osceola County,2528,552,3197,1976,0.79074132,0.172661871,0.618079449
Iowa,19145,Page County,4875,1801,6968,3074,0.699626866,0.258467279,0.441159587
Iowa,19147,Palo Alto County,3079,1395,4674,1684,0.658750535,0.298459564,0.360290971
Iowa,19149,Plymouth County,9659,2878,13057,6781,0.739756452,0.220418167,0.519338285
Iowa,19151,Pocahontas County,2692,962,3831,1730,0.702688593,0.251109371,0.451579222
Iowa,19153,Polk County,93421,119671,228420,-26250,0.408987829,0.523907714,-0.114919885
Iowa,19155,Pottawattamie County,24441,15341,42226,9100,0.578814001,0.363306967,0.215507034
Iowa,19157,Poweshiek County,4936,4272,9693,664,0.509233467,0.440730424,0.068503043
Iowa,19159,Ringgold County,1820,753,2684,1067,0.678092399,0.280551416,0.397540983
Iowa,19161,Sac County,3692,1269,5158,2423,0.715781311,0.246025591,0.46975572
Iowa,19163,Scott County,39083,40302,84878,-1219,0.460460897,0.474822687,-0.01436179
Iowa,19165,Shelby County,4340,1649,6270,2691,0.692185008,0.262998405,0.429186603
Iowa,19167,Sioux County,14761,2289,17989,12472,0.820557007,0.127244427,0.69331258
Iowa,19169,Story County,19111,25085,48910,-5974,0.39073809,0.512880801,-0.122142711
Iowa,19171,Tama County,4968,3194,8636,1774,0.575266327,0.369847151,0.205419176
Iowa,19173,Taylor County,2108,755,3003,1353,0.701964702,0.251415251,0.450549451
Iowa,19175,Union County,3521,1920,5768,1601,0.610436893,0.332871012,0.277565881
Iowa,19177,Van Buren County,2524,843,3526,1681,0.715825298,0.239081112,0.476744186
Iowa,19179,Wapello County,8710,5591,14996,3119,0.580821552,0.372832755,0.207988797
Iowa,19181,Warren County,14773,10371,26916,4402,0.548855699,0.385309853,0.163545846
Iowa,19183,Washington County,6170,3938,10824,2232,0.570029564,0.363821138,0.206208426
Iowa,19185,Wayne County,2069,719,2921,1350,0.708319069,0.246148579,0.46217049
Iowa,19187,Webster County,10049,6293,17239,3756,0.582922443,0.365044376,0.217878067
Iowa,19189,Winnebago County,3437,1920,5717,1517,0.601189435,0.335840476,0.265348959
Iowa,19191,Winneshiek County,5332,5238,11217,94,0.475349915,0.466969778,0.008380137
Iowa,19193,Woodbury County,24627,16102,42933,8525,0.573614702,0.375049496,0.198565206
Iowa,19195,Worth County,2443,1523,4216,920,0.579459203,0.361242884,0.218216319
Iowa,19197,Wright County,3790,1890,5949,1900,0.637081862,0.317700454,0.319381408
Idaho,16001,Ada County,93748,75676,195587,18072,0.47931611,0.386917331,0.092398779
Idaho,16003,Adams County,1556,415,2183,1141,0.712780577,0.19010536,0.522675217
Idaho,16005,Bannock County,17180,10342,33405,6838,0.514294267,0.309594372,0.204699895
Idaho,16007,Bear Lake County,2203,255,2928,1948,0.75239071,0.087090164,0.665300546
Idaho,16009,Benewah County,3101,780,4192,2321,0.739742366,0.186068702,0.553673664
Idaho,16011,Bingham County,10907,2924,16625,7983,0.65606015,0.175879699,0.480180451
Idaho,16013,Blaine County,3340,6416,10723,-3076,0.311479996,0.598340017,-0.286860021
Idaho,16015,Boise County,2673,777,3812,1896,0.701206716,0.20383001,0.497376706
Idaho,16017,Bonner County,10220,5140,16815,5080,0.607790663,0.305679453,0.30211121
Idaho,16019,Bonneville County,26699,8930,44212,17769,0.603885823,0.201981363,0.40190446
Idaho,16021,Boundary County,3789,933,5150,2856,0.735728155,0.181165049,0.554563106
Idaho,16023,Butte County,914,160,1230,754,0.743089431,0.130081301,0.61300813
Idaho,16025,Camas County,410,110,599,300,0.684474124,0.183639399,0.500834725
Idaho,16027,Canyon County,46755,16683,72007,30072,0.649311872,0.231685808,0.417626064
Idaho,16029,Caribou County,2275,271,3035,2004,0.749588138,0.089291598,0.66029654
Idaho,16031,Cassia County,5949,1036,8178,4913,0.727439472,0.12668134,0.600758132
Idaho,16033,Clark County,203,44,283,159,0.717314488,0.155477032,0.561837456
Idaho,16035,Clearwater County,2852,704,3801,2148,0.750328861,0.185214417,0.565114444
Idaho,16037,Custer County,1777,427,2413,1350,0.736427683,0.176958143,0.55946954
Idaho,16039,Elmore County,5816,1814,8519,4002,0.682709238,0.212935791,0.469773447
Idaho,16041,Franklin County,3901,385,5499,3516,0.709401709,0.07001273,0.639388979
Idaho,16043,Fremont County,4091,651,5714,3440,0.715960798,0.113930697,0.602030101
Idaho,16045,Gem County,5980,1229,7952,4751,0.752012072,0.154552314,0.597459758
Idaho,16047,Gooding County,3743,930,5191,2813,0.721055673,0.179156232,0.541899441
Idaho,16049,Idaho County,6441,1196,8223,5245,0.78329077,0.145445701,0.637845069
Idaho,16051,Jefferson County,8436,976,11471,7460,0.735419754,0.085084125,0.650335629
Idaho,16053,Jerome County,7347,2117,10667,5230,0.688759726,0.198462548,0.490297178
Idaho,16055,Kootenai County,44449,16264,66286,28185,0.67056392,0.245361011,0.425202909
Idaho,16057,Latah County,7255,8093,18146,-838,0.399812631,0.445993607,-0.046180976
Idaho,16059,Lemhi County,3011,733,4068,2278,0.740167158,0.180186824,0.559980334
Idaho,16061,Lewis County,1202,270,1590,932,0.755974843,0.169811321,0.586163522
Idaho,16063,Lincoln County,1184,360,1748,824,0.677345538,0.205949657,0.471395881
Idaho,16065,Madison County,8941,1201,15687,7740,0.569962389,0.076560209,0.49340218
Idaho,16067,Minidoka County,4887,1167,6870,3720,0.711353712,0.169868996,0.541484716
Idaho,16069,Nez Perce County,10699,4828,17195,5871,0.62221576,0.280779296,0.341436464
Idaho,16071,Oneida County,1531,184,2068,1347,0.74032882,0.088974855,0.651353965
Idaho,16073,Owyhee County,3052,591,3920,2461,0.778571429,0.150765306,0.627806123
Idaho,16075,Payette County,4306,892,5703,3414,0.755041206,0.156408908,0.598632298
Idaho,16077,Power County,1666,699,2758,967,0.604060914,0.253444525,0.350616389
Idaho,16079,Shoshone County,3297,1384,5120,1913,0.643945313,0.2703125,0.373632813
Idaho,16081,Teton County,2161,2157,4966,4,0.435159082,0.434353605,0.000805477
Idaho,16083,Twin Falls County,21063,6844,31893,14219,0.660427053,0.214592544,0.445834509
Idaho,16085,Valley County,2906,1913,5349,993,0.543279118,0.357636941,0.185642177
Idaho,16087,Washington County,3283,776,4454,2507,0.737090256,0.174225415,0.562864841
Illinois,17001,Adams County,22732,7633,31770,15099,0.715517784,0.240258105,0.475259679
Illinois,17003,Alexander County,1496,1262,2820,234,0.530496454,0.44751773,0.082978724
Illinois,17005,Bond County,4884,2066,7462,2818,0.654516215,0.276869472,0.377646743
Illinois,17007,Boone County,12261,8952,22604,3309,0.542426119,0.3960361,0.146390019
Illinois,17009,Brown County,1776,475,2336,1301,0.760273973,0.203339041,0.556934932
Illinois,17011,Bureau County,9264,6010,16303,3254,0.568238974,0.368643808,0.199595166
Illinois,17013,Calhoun County,1719,739,2556,980,0.672535211,0.289123631,0.38341158
Illinois,17015,Carroll County,4428,2437,7354,1991,0.602121295,0.331384281,0.270737014
Illinois,17017,Cass County,3216,1617,5054,1599,0.636327661,0.319944598,0.316383063
Illinois,17019,Champaign County,33235,49694,89196,-16459,0.372606395,0.557132607,-0.184526212
Illinois,17021,Christian County,10522,3982,15310,6540,0.687263227,0.260091444,0.427171783
Illinois,17023,Clark County,5620,1873,7819,3747,0.71876199,0.239544699,0.479217291
Illinois,17025,Clay County,5009,1014,6278,3995,0.797865562,0.161516406,0.636349156
Illinois,17027,Clinton County,12394,3939,17268,8455,0.717743804,0.228109798,0.489634006
Illinois,17029,Coles County,12985,7285,21580,5700,0.601714551,0.337581094,0.264133457
Illinois,17031,Cook County,440213,1528582,2055215,-1088369,0.214193162,0.743757709,-0.529564547
Illinois,17033,Crawford County,6146,1969,8507,4177,0.722463853,0.231456448,0.491007405
Illinois,17035,Cumberland County,4200,1028,5513,3172,0.761835661,0.186468348,0.575367313
Illinois,17037,DeKalb County,19051,20348,42605,-1297,0.44715409,0.477596526,-0.030442436
Illinois,17039,De Witt County,5072,1907,7469,3165,0.679073504,0.255321998,0.423751506
Illinois,17041,Douglas County,5695,1946,8089,3749,0.704042527,0.240573618,0.463468909
Illinois,17043,DuPage County,164355,222499,412929,-58144,0.39802242,0.538831131,-0.140808711
Illinois,17045,Edgar County,5634,1778,7783,3856,0.723885391,0.228446614,0.495438777
Illinois,17047,Edwards County,2777,432,3312,2345,0.838466184,0.130434783,0.708031401
Illinois,17049,Effingham County,13613,3071,17428,10542,0.78109938,0.176210695,0.604888685
Illinois,17051,Fayette County,7363,1814,9515,5549,0.773830793,0.190646348,0.583184445
Illinois,17053,Ford County,4474,1410,6289,3064,0.711400859,0.224200986,0.487199873
Illinois,17055,Franklin County,13101,4711,18533,8390,0.706901203,0.254195219,0.452705984
Illinois,17057,Fulton County,8482,6118,15609,2364,0.543404446,0.39195336,0.151451086
Illinois,17059,Gallatin County,1942,656,2691,1286,0.721664809,0.243775548,0.477889261
Illinois,17061,Greene County,4139,1202,5542,2937,0.746842295,0.21688921,0.529953085
Illinois,17063,Grundy County,13417,8021,22891,5396,0.586125552,0.35039972,0.235725832
Illinois,17065,Hamilton County,3205,800,4143,2405,0.773594014,0.19309679,0.580497224
Illinois,17067,Hancock County,5713,1744,7818,3969,0.730749552,0.223074955,0.507674597
Illinois,17069,Hardin County,1650,419,2133,1231,0.773558368,0.196436943,0.577121425
Illinois,17071,Henderson County,2153,1151,3480,1002,0.618678161,0.330747126,0.287931035
Illinois,17073,Henry County,13962,8835,24232,5127,0.576180258,0.364600528,0.21157973
Illinois,17075,Iroquois County,9728,2496,12923,7232,0.752766386,0.193144007,0.559622379
Illinois,17077,Jackson County,10889,11619,24509,-730,0.444285773,0.47407075,-0.029784977
Illinois,17079,Jasper County,3973,924,5104,3049,0.778409091,0.181034483,0.597374608
Illinois,17081,Jefferson County,11681,4408,16818,7273,0.694553455,0.262100131,0.432453324
Illinois,17083,Jersey County,7737,2673,10909,5064,0.70923091,0.245027042,0.464203868
Illinois,17085,Jo Daviess County,6113,4452,11177,1661,0.546926725,0.398317974,0.148608751
Illinois,17087,Johnson County,4644,1135,6017,3509,0.771813196,0.188632209,0.583180987
Illinois,17089,Kane County,82087,99389,193500,-17302,0.424222222,0.513638243,-0.089416021
Illinois,17091,Kankakee County,25081,18908,46556,6173,0.538727554,0.406134548,0.132593006
Illinois,17093,Kendall County,24152,23392,50815,760,0.475292729,0.460336515,0.014956214
Illinois,17095,Knox County,10658,9939,21964,719,0.485248589,0.452513203,0.032735386
Illinois,17097,Lake County,108608,168186,293574,-59578,0.369951017,0.572891332,-0.202940315
Illinois,17099,LaSalle County,26269,19277,48447,6992,0.542221397,0.397898735,0.144322662
Illinois,17101,Lawrence County,4517,1288,6039,3229,0.747971518,0.213280344,0.534691174
Illinois,17103,Lee County,8597,5499,15215,3098,0.565034505,0.361419652,0.203614853
Illinois,17105,Livingston County,10197,4005,15096,6192,0.675476948,0.265302067,0.410174881
Illinois,17107,Logan County,8167,3301,12130,4866,0.673289365,0.272135202,0.401154163
Illinois,17115,Macon County,26782,18211,47283,8571,0.56641922,0.385148996,0.181270224
Illinois,17117,Macoupin County,14194,6532,21881,7662,0.648690645,0.298523833,0.350166812
Illinois,17119,Madison County,70295,50336,127902,19959,0.549600475,0.393551313,0.156049162
Illinois,17121,Marion County,11677,4231,16600,7446,0.703433735,0.254879518,0.448554217
Illinois,17123,Marshall County,3776,1784,5903,1992,0.639674742,0.302219211,0.337455531
Illinois,17125,Mason County,4051,2008,6433,2043,0.629721747,0.312140525,0.317581222
Illinois,17127,Massac County,4844,1555,6633,3289,0.730287954,0.234433891,0.495854063
Illinois,17109,McDonough County,6789,5278,12910,1511,0.525871418,0.408830364,0.117041054
Illinois,17111,McHenry County,71117,59827,140145,11290,0.507452995,0.426893575,0.08055942
Illinois,17113,McLean County,37081,35918,78995,1163,0.469409456,0.454687006,0.01472245
Illinois,17129,Menard County,4230,1808,6423,2422,0.658570761,0.281488401,0.37708236
Illinois,17131,Mercer County,4800,3061,8417,1739,0.570274445,0.363668766,0.206605679
Illinois,17133,Monroe County,12614,5522,19074,7092,0.661319073,0.289504037,0.371815036
Illinois,17135,Montgomery County,8616,3490,12829,5126,0.671603399,0.27203991,0.399563489
Illinois,17137,Morgan County,9060,4693,14607,4367,0.620250565,0.321284316,0.298966249
Illinois,17139,Moultrie County,4453,1476,6209,2977,0.717184732,0.23771944,0.479465292
Illinois,17141,Ogle County,14344,8025,23798,6319,0.602739726,0.337213211,0.265526515
Illinois,17143,Peoria County,35299,37436,77465,-2137,0.455676757,0.483263409,-0.027586652
Illinois,17145,Perry County,6816,2433,9706,4383,0.702246033,0.250669689,0.451576344
Illinois,17147,Piatt County,5623,2633,8899,2990,0.631868749,0.295875941,0.335992808
Illinois,17149,Pike County,5749,1412,7458,4337,0.770850094,0.189326897,0.581523197
Illinois,17151,Pope County,1678,374,2132,1304,0.787054409,0.175422139,0.61163227
Illinois,17153,Pulaski County,1583,817,2473,766,0.640113223,0.330367974,0.309745249
Illinois,17155,Putnam County,1762,1143,3076,619,0.572821847,0.371586476,0.201235371
Illinois,17157,Randolph County,9992,3421,14032,6571,0.712086659,0.243799886,0.468286773
Illinois,17159,Richland County,5736,1579,7630,4157,0.751769332,0.206946265,0.544823067
Illinois,17161,Rock Island County,26969,32258,62971,-5289,0.428276508,0.512267552,-0.083991044
Illinois,17165,Saline County,8248,2551,11234,5697,0.734199751,0.227078512,0.507121239
Illinois,17167,Sangamon County,49823,40731,96472,9092,0.516450369,0.422205407,0.094244962
Illinois,17169,Schuyler County,2523,1074,3792,1449,0.665348101,0.283227848,0.382120253
Illinois,17171,Scott County,1965,528,2583,1437,0.760743322,0.204413473,0.556329849
Illinois,17173,Shelby County,8209,2279,10912,5930,0.752291056,0.208852639,0.543438417
Illinois,17163,St. Clair County,53479,60180,119201,-6701,0.448645565,0.504861536,-0.056215971
Illinois,17175,Stark County,1777,748,2707,1029,0.65644625,0.27632065,0.3801256
Illinois,17177,Stephenson County,10845,7531,19525,3314,0.555441741,0.385710627,0.169731114
Illinois,17179,Tazewell County,38620,20568,63347,18052,0.609657916,0.324687831,0.284970085
Illinois,17181,Union County,5780,2389,8514,3391,0.678881842,0.280596664,0.398285178
Illinois,17183,Vermilion County,18582,9876,29799,8706,0.623577972,0.331420517,0.292157455
Illinois,17185,Wabash County,4039,1146,5402,2893,0.747686042,0.212143651,0.535542391
Illinois,17187,Warren County,4267,2983,7700,1284,0.554155844,0.387402597,0.166753247
Illinois,17189,Washington County,5566,1446,7376,4120,0.754609544,0.196041215,0.558568329
Illinois,17191,Wayne County,6963,1048,8256,5915,0.843386628,0.126937984,0.716448644
Illinois,17193,White County,5639,1412,7289,4227,0.7736315,0.193716559,0.579914941
Illinois,17195,Whiteside County,12597,11005,25210,1592,0.499682666,0.436533122,0.063149544
Illinois,17197,Will County,129726,146230,291010,-16504,0.445778496,0.502491323,-0.056712827
Illinois,17199,Williamson County,21503,8539,31422,12964,0.684329451,0.271752275,0.412577176
Illinois,17201,Winnebago County,53922,52595,113027,1327,0.47707185,0.465331293,0.011740557
Illinois,17203,Woodford County,13180,5068,19389,8112,0.679766878,0.261385322,0.418381556
Indiana,18001,Adams County,9642,2802,13039,6840,0.739473886,0.21489378,0.524580106
Indiana,18003,Allen County,83801,55222,145787,28579,0.574818056,0.378785488,0.196032568
Indiana,18005,Bartholomew County,20637,9841,32389,10796,0.637160764,0.303837723,0.333323041
Indiana,18007,Benton County,2579,860,3654,1719,0.705801861,0.235358511,0.47044335
Indiana,18009,Blackford County,3349,1243,4822,2106,0.694525093,0.257776856,0.436748237
Indiana,18011,Boone County,19654,10181,32061,9473,0.613018933,0.317550919,0.295468014
Indiana,18013,Brown County,5015,2518,7908,2497,0.634167931,0.318411735,0.315756196
Indiana,18015,Carroll County,6273,1891,8609,4382,0.728656058,0.219653851,0.509002207
Indiana,18017,Cass County,9697,3758,14135,5939,0.686027591,0.265864874,0.420162717
Indiana,18019,Clark County,30012,18791,51104,11221,0.587273012,0.367701158,0.219571854
Indiana,18021,Clay County,8528,2306,11259,6222,0.757438494,0.204813927,0.552624567
Indiana,18023,Clinton County,8530,2819,11896,5711,0.717047747,0.23697041,0.480077337
Indiana,18025,Crawford County,3013,1323,4591,1690,0.656284034,0.288172511,0.368111523
Indiana,18027,Daviess County,8545,1800,10736,6745,0.795920268,0.167660209,0.628260059
Indiana,18029,Dearborn County,18110,4883,23910,13227,0.757423672,0.204224174,0.553199498
Indiana,18031,Decatur County,8488,2121,11095,6367,0.765029292,0.191167192,0.5738621
Indiana,18033,DeKalb County,12054,3941,16816,8113,0.716817317,0.234360133,0.482457184
Indiana,18035,Delaware County,24217,18100,44699,6117,0.541779458,0.404930759,0.136848699
Indiana,18037,Dubois County,13365,5389,19917,7976,0.671034794,0.270572877,0.400461917
Indiana,18039,Elkhart County,41810,20667,65187,21143,0.641385552,0.317041741,0.324343811
Indiana,18041,Fayette County,6839,2252,9530,4587,0.717628541,0.236306401,0.48132214
Indiana,18043,Floyd County,21427,13939,37225,7488,0.57560779,0.374452653,0.201155137
Indiana,18045,Fountain County,5661,1476,7474,4185,0.757425743,0.197484613,0.55994113
Indiana,18047,Franklin County,8665,1967,10990,6698,0.78844404,0.178980892,0.609463148
Indiana,18049,Fulton County,6010,1960,8374,4050,0.717697636,0.234057798,0.483639838
Indiana,18051,Gibson County,11079,3720,15472,7359,0.716067735,0.240434333,0.475633402
Indiana,18053,Grant County,17009,7029,25239,9980,0.67391735,0.278497563,0.395419787
Indiana,18055,Greene County,10275,2929,13763,7346,0.746566882,0.212816973,0.533749909
Indiana,18057,Hamilton County,87299,57214,153630,30085,0.56824188,0.372414242,0.195827638
Indiana,18059,Hancock County,25050,8901,36027,16149,0.695311849,0.247064701,0.448247148
Indiana,18061,Harrison County,12993,4776,18528,8217,0.701262953,0.257772021,0.443490932
Indiana,18063,Hendricks County,48326,22595,75258,25731,0.642137713,0.300233862,0.341903851
Indiana,18065,Henry County,13895,5124,20075,8771,0.692154421,0.255242839,0.436911582
Indiana,18067,Howard County,23675,11215,36754,12460,0.644147576,0.305136856,0.33901072
Indiana,18069,Huntington County,11649,3506,15974,8143,0.729247527,0.219481658,0.509765869
Indiana,18071,Jackson County,12857,3843,17532,9014,0.733344741,0.219199179,0.514145562
Indiana,18073,Jasper County,9382,3329,13331,6053,0.70377316,0.249718701,0.454054459
Indiana,18075,Jay County,5697,1889,7962,3808,0.715523738,0.237251947,0.478271791
Indiana,18077,Jefferson County,8538,4325,13461,4213,0.6342768,0.321298566,0.312978234
Indiana,18079,Jennings County,8222,2364,11115,5858,0.739721098,0.21268556,0.527035538
Indiana,18081,Johnson County,45456,17318,66229,28138,0.686345861,0.26148666,0.424859201
Indiana,18083,Knox County,11077,3772,15483,7305,0.715429826,0.243622037,0.471807789
Indiana,18085,Kosciusko County,23909,6311,31907,17598,0.749334002,0.197793588,0.551540414
Indiana,18087,LaGrange County,7025,2080,9552,4945,0.735448074,0.217755444,0.51769263
Indiana,18089,Lake County,75565,116896,200247,-41331,0.377358962,0.583759058,-0.206400096
Indiana,18091,LaPorte County,22678,19795,44994,2883,0.504022759,0.439947549,0.06407521
Indiana,18093,Lawrence County,14034,4210,19076,9824,0.735688824,0.220696163,0.514992661
Indiana,18095,Madison County,32376,18595,53660,13781,0.603354454,0.346533731,0.256820723
Indiana,18097,Marion County,130228,212676,361070,-82448,0.360672446,0.58901598,-0.228343534
Indiana,18099,Marshall County,12286,4798,18008,7488,0.682252332,0.266437139,0.415815193
Indiana,18101,Martin County,3695,881,4807,2814,0.768670689,0.183274392,0.585396297
Indiana,18103,Miami County,9975,2766,13440,7209,0.7421875,0.205803571,0.536383929
Indiana,18105,Monroe County,20527,34183,57623,-13656,0.356229283,0.593217986,-0.236988703
Indiana,18107,Montgomery County,11051,3362,15101,7689,0.731805841,0.222634263,0.509171578
Indiana,18109,Morgan County,23671,6037,31180,17634,0.759172547,0.193617704,0.565554843
Indiana,18111,Newton County,4074,1403,5791,2671,0.703505439,0.242272492,0.461232947
Indiana,18113,Noble County,12198,3904,16890,8294,0.722202487,0.231142688,0.491059799
Indiana,18115,Ohio County,2118,686,2917,1432,0.726088447,0.235173123,0.490915324
Indiana,18117,Orange County,5800,2048,8189,3752,0.708267188,0.250091586,0.458175602
Indiana,18119,Owen County,6151,1946,8520,4205,0.721948357,0.228403756,0.493544601
Indiana,18121,Parke County,4863,1441,6576,3422,0.739507299,0.21913017,0.520377129
Indiana,18123,Perry County,4556,3062,8025,1494,0.567725857,0.381557632,0.186168225
Indiana,18125,Pike County,4398,1297,5977,3101,0.735820646,0.216998494,0.518822152
Indiana,18127,Porter County,38719,33531,76492,5188,0.506183653,0.438359567,0.067824086
Indiana,18129,Posey County,8393,3515,12448,4878,0.674244859,0.282374679,0.39187018
Indiana,18131,Pulaski County,3854,1327,5437,2527,0.708846791,0.24406842,0.464778371
Indiana,18133,Putnam County,10637,3356,14680,7281,0.724591281,0.228610354,0.495980927
Indiana,18135,Randolph County,7515,2446,10456,5069,0.71872609,0.23393267,0.48479342
Indiana,18137,Ripley County,9806,2471,12790,7335,0.766692729,0.193197811,0.573494918
Indiana,18139,Rush County,5292,1525,7214,3767,0.733573607,0.211394511,0.522179096
Indiana,18143,Scott County,6074,2642,9060,3432,0.670419426,0.291611479,0.378807947
Indiana,18145,Shelby County,12718,4247,17935,8471,0.709116253,0.236799554,0.472316699
Indiana,18147,Spencer County,6572,2861,9959,3711,0.659905613,0.287277839,0.372627774
Indiana,18141,St. Joseph County,52019,52247,109452,-228,0.475267697,0.477350802,-0.002083105
Indiana,18149,Starke County,6367,2489,9226,3878,0.690114893,0.269781054,0.420333839
Indiana,18151,Steuben County,10127,3741,14530,6386,0.696971783,0.257467309,0.439504474
Indiana,18153,Sullivan County,6138,2113,8559,4025,0.717139853,0.246874635,0.470265218
Indiana,18155,Switzerland County,2558,930,3639,1628,0.702940368,0.255564716,0.447375652
Indiana,18157,Tippecanoe County,30711,27207,61916,3504,0.496010724,0.439417921,0.056592803
Indiana,18159,Tipton County,5589,1587,7510,4002,0.744207723,0.211318242,0.532889481
Indiana,18161,Union County,2445,715,3286,1730,0.744065733,0.217589775,0.526475958
Indiana,18163,Vanderburgh County,40422,28296,71957,12126,0.561752158,0.393234849,0.168517309
Indiana,18165,Vermillion County,4511,2081,6913,2430,0.652538695,0.30102705,0.351511645
Indiana,18167,Vigo County,21924,15922,39569,6002,0.554070105,0.402385706,0.151684399
Indiana,18169,Wabash County,9819,3018,13415,6801,0.731941856,0.224972046,0.50696981
Indiana,18171,Warren County,2896,839,3919,2057,0.738964021,0.214085226,0.524878795
Indiana,18173,Warrick County,19133,9086,29609,10047,0.646188659,0.306866156,0.339322503
Indiana,18175,Washington County,8206,2636,11333,5570,0.72408012,0.232595076,0.491485044
Indiana,18177,Wayne County,16028,8322,25575,7706,0.626705767,0.325395894,0.301309873
Indiana,18179,Wells County,9999,2585,13123,7414,0.761944677,0.196982397,0.56496228
Indiana,18181,White County,6813,2563,9902,4250,0.68804282,0.258836599,0.429206221
Indiana,18183,Whitley County,11357,3379,15535,7978,0.731058899,0.217508851,0.513550048
Kansas,20001,Allen County,3575,1398,5314,2177,0.672751223,0.26307866,0.409672563
Kansas,20003,Anderson County,2386,665,3277,1721,0.728104974,0.202929509,0.525175465
Kansas,20005,Atchison County,3977,1946,6393,2031,0.622086657,0.304395433,0.317691224
Kansas,20007,Barber County,1822,281,2209,1541,0.824807605,0.127206881,0.697600724
Kansas,20009,Barton County,7766,1823,10088,5943,0.769825535,0.180709754,0.589115781
Kansas,20011,Bourbon County,4314,1306,5918,3008,0.728962487,0.220682663,0.508279824
Kansas,20013,Brown County,2861,850,3960,2011,0.722474747,0.214646465,0.507828282
Kansas,20015,Butler County,18781,6489,27051,12292,0.694281173,0.239880226,0.454400947
Kansas,20017,Chase County,964,313,1342,651,0.718330849,0.233233979,0.48509687
Kansas,20019,Chautauqua County,1552,236,1845,1316,0.841192412,0.127913279,0.713279133
Kansas,20021,Cherokee County,6017,1959,8386,4058,0.717505366,0.233603625,0.483901741
Kansas,20023,Cheyenne County,1172,188,1409,984,0.8317956,0.133427963,0.698367637
Kansas,20025,Clark County,813,118,983,695,0.82706002,0.120040692,0.707019328
Kansas,20027,Clay County,2831,665,3727,2166,0.759592165,0.17842769,0.581164475
Kansas,20029,Cloud County,2856,744,3831,2112,0.745497259,0.194205168,0.551292091
Kansas,20031,Coffey County,2990,719,3962,2271,0.754669359,0.181474003,0.573195356
Kansas,20033,Comanche County,705,102,857,603,0.822637106,0.119019837,0.703617269
Kansas,20035,Cowley County,8016,3436,12171,4580,0.65861474,0.28231041,0.37630433
Kansas,20037,Crawford County,8394,5064,14404,3330,0.58275479,0.351569009,0.231185781
Kansas,20039,Decatur County,1220,178,1460,1042,0.835616438,0.121917808,0.71369863
Kansas,20041,Dickinson County,5905,1582,8008,4323,0.737387612,0.197552448,0.539835164
Kansas,20043,Doniphan County,2601,584,3366,2017,0.772727273,0.173499703,0.59922757
Kansas,20045,Douglas County,14308,30089,48231,-15781,0.296655678,0.623851879,-0.327196201
Kansas,20047,Edwards County,1033,208,1308,825,0.789755352,0.159021407,0.630733945
Kansas,20049,Elk County,1048,160,1259,888,0.832406672,0.127084988,0.705321684
Kansas,20051,Ellis County,8311,2669,11660,5642,0.712778731,0.22890223,0.483876501
Kansas,20053,Ellsworth County,1933,515,2626,1418,0.736100533,0.196115765,0.539984768
Kansas,20055,Finney County,6155,3006,9731,3149,0.632514644,0.30890967,0.323604974
Kansas,20057,Ford County,4994,2032,7425,2962,0.672592593,0.273670034,0.398922559
Kansas,20059,Franklin County,7025,2829,10658,4196,0.659129293,0.265434415,0.393694878
Kansas,20061,Geary County,4116,2569,7129,1547,0.577360079,0.360359097,0.217000982
Kansas,20063,Gove County,1127,149,1328,978,0.848644578,0.112198795,0.736445783
Kansas,20065,Graham County,1013,185,1265,828,0.800790514,0.146245059,0.654545455
Kansas,20067,Grant County,1755,427,2311,1328,0.75941151,0.184768498,0.574643012
Kansas,20069,Gray County,1651,257,2011,1394,0.820984585,0.127797116,0.693187469
Kansas,20071,Greeley County,523,83,639,440,0.818466354,0.129890454,0.6885759
Kansas,20073,Greenwood County,2146,484,2811,1662,0.763429385,0.172180719,0.591248666
Kansas,20075,Hamilton County,690,114,847,576,0.814639906,0.13459268,0.680047226
Kansas,20077,Harper County,1950,388,2513,1562,0.775964982,0.154397135,0.621567847
Kansas,20079,Harvey County,8503,5006,14540,3497,0.58480055,0.344291609,0.240508941
Kansas,20081,Haskell County,1011,228,1300,783,0.777692308,0.175384615,0.602307693
Kansas,20083,Hodgeman County,845,124,1006,721,0.839960239,0.123260437,0.716699802
Kansas,20085,Jackson County,3888,1489,5727,2399,0.678889471,0.259996508,0.418892963
Kansas,20087,Jefferson County,5112,2483,8151,2629,0.627162311,0.304625199,0.322537112
Kansas,20089,Jewell County,1204,180,1483,1024,0.811867835,0.12137559,0.690492245
Kansas,20091,Johnson County,133907,126324,279753,7583,0.478661534,0.451555479,0.027106055
Kansas,20093,Kearny County,1048,224,1325,824,0.790943396,0.169056604,0.621886792
Kansas,20095,Kingman County,2507,594,3281,1913,0.764096312,0.181042365,0.583053947
Kansas,20097,Kiowa County,855,111,1023,744,0.835777126,0.108504399,0.727272727
Kansas,20099,Labette County,5232,2234,7919,2998,0.660689481,0.282106327,0.378583154
Kansas,20101,Lane County,684,104,831,580,0.823104693,0.125150421,0.697954272
Kansas,20103,Leavenworth County,17387,10064,29676,7323,0.585894325,0.339129263,0.246765062
Kansas,20105,Lincoln County,1168,214,1448,954,0.806629834,0.147790055,0.658839779
Kansas,20107,Linn County,3377,721,4279,2656,0.789203085,0.168497312,0.620705773
Kansas,20109,Logan County,1124,149,1348,975,0.833827893,0.110534125,0.723293768
Kansas,20111,Lyon County,6354,4456,11745,1898,0.540996169,0.379395487,0.161600682
Kansas,20115,Marion County,3928,1177,5465,2751,0.718755718,0.21537054,0.503385178
Kansas,20117,Marshall County,3250,1060,4578,2190,0.709916994,0.231542158,0.478374836
Kansas,20113,McPherson County,8407,3183,12443,5224,0.675640923,0.255806478,0.419834445
Kansas,20119,Meade County,1390,206,1675,1184,0.829850746,0.122985075,0.706865671
Kansas,20121,Miami County,9839,3949,14712,5890,0.66877379,0.268420337,0.400353453
Kansas,20123,Mitchell County,2216,469,2824,1747,0.78470255,0.166076487,0.618626063
Kansas,20125,Montgomery County,8466,2557,11623,5909,0.728383378,0.219994838,0.50838854
Kansas,20127,Morris County,1790,586,2568,1204,0.697040498,0.228193146,0.468847352
Kansas,20129,Morton County,970,145,1160,825,0.836206897,0.125,0.711206897
Kansas,20131,Nemaha County,4066,714,5025,3352,0.809154229,0.142089552,0.667064677
Kansas,20133,Neosho County,4340,1464,6151,2876,0.705576329,0.23801008,0.467566249
Kansas,20135,Ness County,1216,160,1435,1056,0.84738676,0.111498258,0.735888502
Kansas,20137,Norton County,1808,277,2190,1531,0.825570776,0.126484018,0.699086758
Kansas,20139,Osage County,4713,1730,6894,2983,0.683637946,0.250942849,0.432695097
Kansas,20141,Osborne County,1437,231,1753,1206,0.819737593,0.131774102,0.687963491
Kansas,20143,Ottawa County,2261,424,2866,1837,0.788904396,0.147941382,0.640963014
Kansas,20145,Pawnee County,1872,567,2602,1305,0.71944658,0.217909301,0.501537279
Kansas,20147,Phillips County,2200,296,2611,1904,0.842589046,0.113366526,0.72922252
Kansas,20149,Pottawatomie County,7451,2191,10359,5260,0.719277923,0.211506902,0.507771021
Kansas,20151,Pratt County,2824,769,3806,2055,0.741986337,0.202049396,0.539936941
Kansas,20153,Rawlins County,1209,160,1448,1049,0.834944751,0.110497238,0.724447513
Kansas,20155,Reno County,15100,6670,23448,8430,0.643978164,0.284459229,0.359518935
Kansas,20157,Republic County,1993,370,2484,1623,0.802334944,0.148953301,0.653381643
Kansas,20159,Rice County,2652,668,3567,1984,0.743481918,0.187272218,0.5562097
Kansas,20161,Riley County,9817,8892,20475,925,0.479462759,0.434285714,0.045177045
Kansas,20163,Rooks County,1999,273,2378,1726,0.840622372,0.114802355,0.725820017
Kansas,20165,Rush County,1177,227,1474,950,0.798507463,0.154002714,0.644504749
Kansas,20167,Russell County,2544,454,3148,2090,0.808132147,0.144218551,0.663913596
Kansas,20169,Saline County,13367,6084,21206,7283,0.63034047,0.286899934,0.343440536
Kansas,20171,Scott County,1832,232,2159,1600,0.848540991,0.107457156,0.741083835
Kansas,20173,Sedgwick County,101319,66716,180750,34603,0.560547718,0.369106501,0.191441217
Kansas,20175,Seward County,3025,1491,4743,1534,0.637781995,0.314358001,0.323423994
Kansas,20177,Shawnee County,35349,33270,73648,2079,0.479972301,0.451743428,0.028228873
Kansas,20179,Sheridan County,1186,126,1362,1060,0.870778267,0.092511013,0.778267254
Kansas,20181,Sherman County,2043,340,2537,1703,0.805281829,0.134016555,0.671265274
Kansas,20183,Smith County,1635,295,2014,1340,0.811817279,0.146474677,0.665342602
Kansas,20185,Stafford County,1485,303,1884,1182,0.788216561,0.160828025,0.627388536
Kansas,20187,Stanton County,580,132,742,448,0.781671159,0.177897574,0.603773585
Kansas,20189,Stevens County,1564,215,1853,1349,0.844036697,0.116028063,0.728008634
Kansas,20191,Sumner County,6844,2039,9494,4805,0.720876343,0.214767221,0.506109122
Kansas,20193,Thomas County,2832,467,3483,2365,0.813092162,0.134079816,0.679012346
Kansas,20195,Trego County,1211,193,1459,1018,0.830020562,0.132282385,0.697738177
Kansas,20197,Wabaunsee County,2358,773,3340,1585,0.705988024,0.231437126,0.474550898
Kansas,20199,Wallace County,711,45,779,666,0.912708601,0.057766367,0.854942234
Kansas,20201,Washington County,2136,378,2677,1758,0.797908106,0.141202839,0.656705267
Kansas,20203,Wichita County,765,139,934,626,0.819057816,0.14882227,0.670235546
Kansas,20205,Wilson County,2747,550,3482,2197,0.788914417,0.157955198,0.630959219
Kansas,20207,Woodson County,1063,270,1420,793,0.748591549,0.190140845,0.558450704
Kansas,20209,Wyandotte County,15520,29346,47467,-13826,0.326963996,0.61824004,-0.291276044
Kentucky,21001,Adair County,6637,1323,8228,5314,0.806635877,0.160792416,0.645843461
Kentucky,21003,Allen County,6466,1349,8085,5117,0.799752628,0.166852195,0.632900433
Kentucky,21005,Anderson County,8242,2634,11414,5608,0.722095672,0.230769231,0.491326441
Kentucky,21007,Ballard County,3161,816,4097,2345,0.771540151,0.199170124,0.572370027
Kentucky,21009,Barren County,13483,4275,18473,9208,0.729876035,0.231418827,0.498457208
Kentucky,21011,Bath County,3082,1361,4577,1721,0.673366834,0.297356347,0.376010487
Kentucky,21013,Bell County,7764,1720,9714,6044,0.799258802,0.177064031,0.622194771
Kentucky,21015,Boone County,39082,15026,57550,24056,0.679096438,0.2610947,0.418001738
Kentucky,21017,Bourbon County,5569,2791,8791,2778,0.633488795,0.31748379,0.316005005
Kentucky,21019,Boyd County,13591,6021,20443,7570,0.664824145,0.294526244,0.370297901
Kentucky,21021,Boyle County,8040,4281,12928,3759,0.621905941,0.331141708,0.290764233
Kentucky,21023,Bracken County,2711,705,3522,2006,0.769733106,0.200170358,0.569562748
Kentucky,21025,Breathitt County,3991,1537,5728,2454,0.696752793,0.268331006,0.428421787
Kentucky,21027,Breckinridge County,6484,1960,8765,4524,0.739760411,0.223616657,0.516143754
Kentucky,21029,Bullitt County,26210,8255,36036,17955,0.727328227,0.229076479,0.498251748
Kentucky,21031,Butler County,4428,947,5575,3481,0.79426009,0.169865471,0.624394619
Kentucky,21033,Caldwell County,4507,1260,5972,3247,0.754688547,0.210984595,0.543703952
Kentucky,21035,Calloway County,10367,4749,16039,5618,0.646361993,0.296090779,0.350271214
Kentucky,21037,Campbell County,25050,14658,42471,10392,0.589814226,0.345129618,0.244684608
Kentucky,21039,Carlisle County,2094,432,2599,1662,0.805694498,0.166217776,0.639476722
Kentucky,21041,Carroll County,2588,1106,3851,1482,0.672033238,0.28719813,0.384835108
Kentucky,21043,Carter County,7587,2276,10267,5311,0.738969514,0.221681114,0.5172884
Kentucky,21045,Casey County,5482,767,6438,4715,0.851506679,0.119136378,0.732370301
Kentucky,21047,Christian County,14108,7188,22069,6920,0.639267751,0.325705741,0.31356201
Kentucky,21049,Clark County,10710,4706,16193,6004,0.6613969,0.290619403,0.370777497
Kentucky,21051,Clay County,5861,752,6762,5109,0.866755398,0.111209701,0.755545697
Kentucky,21053,Clinton County,3809,547,4454,3262,0.855186349,0.122810956,0.732375393
Kentucky,21055,Crittenden County,3290,617,4036,2673,0.815163528,0.152874133,0.662289395
Kentucky,21057,Cumberland County,2502,459,3061,2043,0.817379941,0.149950996,0.667428945
Kentucky,21059,Daviess County,28907,14163,45752,14744,0.631819374,0.309560238,0.322259136
Kentucky,21061,Edmonson County,4135,979,5239,3156,0.789272762,0.186867723,0.602405039
Kentucky,21063,Elliott County,2000,740,2847,1260,0.702493853,0.259922726,0.442571127
Kentucky,21065,Estill County,4236,1108,5538,3128,0.764897075,0.200072228,0.564824847
Kentucky,21067,Fayette County,56890,69776,136112,-12886,0.417964617,0.512636652,-0.094672035
Kentucky,21069,Fleming County,4722,1348,6250,3374,0.75552,0.21568,0.53984
Kentucky,21071,Floyd County,11993,4015,16521,7978,0.725924581,0.24302403,0.482900551
Kentucky,21073,Franklin County,11819,10717,23840,1102,0.495763423,0.449538591,0.046224832
Kentucky,21075,Fulton County,1549,774,2381,775,0.650566989,0.325073499,0.32549349
Kentucky,21077,Gallatin County,2443,749,3334,1694,0.732753449,0.224655069,0.50809838
Kentucky,21079,Garrard County,5904,1453,7613,4451,0.775515565,0.190857743,0.584657822
Kentucky,21081,Grant County,7268,1910,9551,5358,0.760967438,0.19997906,0.560988378
Kentucky,21083,Graves County,12671,3308,16582,9363,0.764141841,0.199493427,0.564648414
Kentucky,21085,Grayson County,8219,1959,10564,6260,0.77801969,0.185441121,0.592578569
Kentucky,21087,Green County,4372,832,5331,3540,0.820108798,0.15606828,0.664040518
Kentucky,21089,Greenup County,11546,4146,16265,7400,0.709867814,0.254903166,0.454964648
Kentucky,21091,Hancock County,2788,1244,4292,1544,0.649580615,0.289841566,0.359739049
Kentucky,21093,Hardin County,26970,13944,43113,13026,0.625565375,0.323429128,0.302136247
Kentucky,21095,Harlan County,9129,1372,10744,7757,0.849683544,0.127699181,0.721984363
Kentucky,21097,Harrison County,5435,2031,7774,3404,0.699125289,0.261255467,0.437869822
Kentucky,21099,Hart County,5320,1730,7261,3590,0.732681449,0.238259193,0.494422256
Kentucky,21101,Henderson County,12159,6707,19692,5452,0.617458867,0.340595166,0.276863701
Kentucky,21103,Henry County,4944,1828,7142,3116,0.692243069,0.255950714,0.436292355
Kentucky,21105,Hickman County,1657,449,2157,1208,0.768196569,0.208159481,0.560037088
Kentucky,21107,Hopkins County,15277,4310,20325,10967,0.751635916,0.212054121,0.539581795
Kentucky,21109,Jackson County,4889,482,5497,4407,0.889394215,0.087684191,0.801710024
Kentucky,21111,Jefferson County,143758,190824,352778,-47066,0.407502735,0.540918084,-0.133415349
Kentucky,21113,Jessamine County,15474,6144,23292,9330,0.664348274,0.263781556,0.400566718
Kentucky,21115,Johnson County,8043,1250,9560,6793,0.841317992,0.130753138,0.710564854
Kentucky,21117,Kenton County,42958,24213,71905,18745,0.597427161,0.336735971,0.26069119
Kentucky,21119,Knott County,4357,1245,5756,3112,0.75694927,0.216296039,0.540653231
Kentucky,21121,Knox County,9885,1761,12001,8124,0.82368136,0.146737772,0.676943588
Kentucky,21123,Larue County,4799,1278,6359,3521,0.754678409,0.200974996,0.553703413
Kentucky,21125,Laurel County,20592,3440,24811,17152,0.829954456,0.13864818,0.691306276
Kentucky,21127,Lawrence County,4816,1045,6037,3771,0.797747225,0.173099221,0.624648004
Kentucky,21129,Lee County,2151,444,2663,1707,0.807735637,0.166729253,0.641006384
Kentucky,21131,Leslie County,4015,400,4487,3615,0.894807221,0.089146423,0.805660798
Kentucky,21133,Letcher County,7293,1542,9131,5751,0.798707699,0.16887526,0.629832439
Kentucky,21135,Lewis County,4363,785,5293,3578,0.82429624,0.148309087,0.675987153
Kentucky,21137,Lincoln County,7338,1865,9555,5473,0.767974882,0.195185767,0.572789115
Kentucky,21139,Livingston County,3570,887,4642,2683,0.769065058,0.19108143,0.577983628
Kentucky,21141,Logan County,7778,2755,10896,5023,0.713839941,0.252845081,0.46099486
Kentucky,21143,Lyon County,2789,1045,3959,1744,0.704470826,0.263955544,0.440515282
Kentucky,21151,Madison County,23431,11793,37318,11638,0.627873948,0.31601372,0.311860228
Kentucky,21153,Magoffin County,3824,1172,5113,2652,0.747897516,0.229219636,0.51867788
Kentucky,21155,Marion County,5122,2679,8108,2443,0.631721756,0.330414406,0.30130735
Kentucky,21157,Marshall County,12322,3672,16678,8650,0.738817604,0.220170284,0.51864732
Kentucky,21159,Martin County,3503,363,3951,3140,0.886610985,0.091875475,0.79473551
Kentucky,21161,Mason County,4944,1970,7212,2974,0.685524126,0.273155851,0.412368275
Kentucky,21145,McCracken County,20774,9134,31284,11640,0.664045518,0.291970336,0.372075182
Kentucky,21147,McCreary County,5012,664,5772,4348,0.868329868,0.115038115,0.753291753
Kentucky,21149,McLean County,3381,988,4565,2393,0.740635268,0.216429354,0.524205914
Kentucky,21163,Meade County,8660,3026,12223,5634,0.708500368,0.247566064,0.460934304
Kentucky,21165,Menifee County,2010,700,2779,1310,0.723281756,0.251889169,0.471392587
Kentucky,21167,Mercer County,7740,2395,10579,5345,0.731638151,0.226391908,0.505246243
Kentucky,21169,Metcalfe County,3491,976,4616,2515,0.756282496,0.211438475,0.544844021
Kentucky,21171,Monroe County,4278,601,4991,3677,0.857142857,0.12041675,0.736726107
Kentucky,21173,Montgomery County,7856,3158,11437,4698,0.686893416,0.27612136,0.410772056
Kentucky,21175,Morgan County,3628,1006,4766,2622,0.761225346,0.211078473,0.550146873
Kentucky,21177,Muhlenberg County,9393,3272,13046,6121,0.719990802,0.250804844,0.469185958
Kentucky,21179,Nelson County,13430,6434,20761,6996,0.646885988,0.309908001,0.336977987
Kentucky,21181,Nicholas County,1957,787,2837,1170,0.689813183,0.27740571,0.412407473
Kentucky,21183,Ohio County,7942,2080,10398,5862,0.763800731,0.200038469,0.563762262
Kentucky,21185,Oldham County,20469,10268,32838,10201,0.623332724,0.312686522,0.310646202
Kentucky,21187,Owen County,3745,1062,4997,2683,0.74944967,0.212527517,0.536922153
Kentucky,21189,Owsley County,1474,256,1757,1218,0.838929994,0.145702903,0.693227091
Kentucky,21191,Pendleton County,4604,1164,6006,3440,0.766566767,0.193806194,0.572760573
Kentucky,21193,Perry County,8158,2136,10566,6022,0.772099186,0.202157865,0.569941321
Kentucky,21195,Pike County,19740,4277,24637,15463,0.801233916,0.173600682,0.627633234
Kentucky,21197,Powell County,3513,1272,4952,2241,0.709410339,0.256865913,0.452544426
Kentucky,21199,Pulaski County,22900,4208,28015,18692,0.81741924,0.150205247,0.667213993
Kentucky,21201,Robertson County,759,222,1013,537,0.749259625,0.219151037,0.530108588
Kentucky,21203,Rockcastle County,5609,915,6686,4694,0.83891714,0.136853126,0.702064014
Kentucky,21205,Rowan County,5174,3295,8829,1879,0.586023332,0.373201948,0.212821384
Kentucky,21207,Russell County,6863,1093,8171,5770,0.839921674,0.133765757,0.706155917
Kentucky,21209,Scott County,15052,7713,24159,7339,0.623039033,0.319259903,0.30377913
Kentucky,21211,Shelby County,13196,6276,20563,6920,0.641735155,0.305208384,0.336526771
Kentucky,21213,Simpson County,5077,2144,7524,2933,0.674774056,0.284954811,0.389819245
Kentucky,21215,Spencer County,7196,1921,9509,5275,0.756756757,0.20201914,0.554737617
Kentucky,21217,Taylor County,8320,2553,11301,5767,0.736218034,0.225909212,0.510308822
Kentucky,21219,Todd County,3612,1042,4771,2570,0.757073989,0.218402851,0.538671138
Kentucky,21221,Trigg County,4928,1587,6740,3341,0.73115727,0.235459941,0.495697329
Kentucky,21223,Trimble County,2771,879,3786,1892,0.731907026,0.232171157,0.499735869
Kentucky,21225,Union County,4701,1331,6209,3370,0.757126751,0.214366243,0.542760508
Kentucky,21227,Warren County,28673,16966,48416,11707,0.59222158,0.350421348,0.241800232
Kentucky,21229,Washington County,4013,1420,5621,2593,0.713929906,0.252624088,0.461305818
Kentucky,21231,Wayne County,6370,1431,7988,4939,0.797446169,0.179143716,0.618302453
Kentucky,21233,Webster County,4397,1240,5804,3157,0.757580979,0.213645762,0.543935217
Kentucky,21235,Whitley County,11312,2067,13765,9245,0.821794406,0.150163458,0.671630948
Kentucky,21237,Wolfe County,1804,753,2634,1051,0.684889901,0.285876993,0.399012908
Kentucky,21239,Woodford County,7697,4958,13547,2739,0.568170075,0.365985089,0.202184986
Louisiana,22001,Acadia Parish,21159,5638,27386,15521,0.772621047,0.205871613,0.566749434
Louisiana,22003,Allen Parish,6867,2106,9245,4761,0.742779881,0.22779881,0.514981071
Louisiana,22005,Ascension Parish,36135,16471,54663,19664,0.661050436,0.301318991,0.359731445
Louisiana,22007,Assumption Parish,6714,3931,10904,2783,0.615737344,0.360509905,0.255227439
Louisiana,22009,Avoyelles Parish,11163,5032,16581,6131,0.673240456,0.303479887,0.369760569
Louisiana,22011,Beauregard Parish,12238,2393,15078,9845,0.811646107,0.158708051,0.652938056
Louisiana,22013,Bienville Parish,3756,3129,7005,627,0.536188437,0.446680942,0.089507495
Louisiana,22015,Bossier Parish,35451,12638,49818,22813,0.711610261,0.253683408,0.457926853
Louisiana,22017,Caddo Parish,48977,53448,105737,-4471,0.463196421,0.505480579,-0.042284158
Louisiana,22019,Calcasieu Parish,54182,26293,83773,27889,0.646771633,0.313860074,0.332911559
Louisiana,22021,Caldwell Parish,3822,788,4692,3034,0.814578005,0.167945439,0.646632566
Louisiana,22023,Cameron Parish,3256,323,3692,2933,0.881906826,0.087486457,0.794420369
Louisiana,22025,Catahoula Parish,3479,1322,4856,2157,0.716433278,0.272240527,0.444192751
Louisiana,22027,Claiborne Parish,3585,2717,6421,868,0.558324249,0.423142813,0.135181436
Louisiana,22029,Concordia Parish,5474,3272,8869,2202,0.617205998,0.368925471,0.248280527
Louisiana,22031,De Soto Parish,8067,5163,13497,2904,0.597688375,0.382529451,0.215158924
Louisiana,22033,East Baton Rouge Parish,84620,102711,196332,-18091,0.431004625,0.523149563,-0.092144938
Louisiana,22035,East Carroll Parish,1059,1838,2939,-779,0.360326642,0.625382783,-0.265056141
Louisiana,22037,East Feliciana Parish,5569,4235,10042,1334,0.554570803,0.421728739,0.132842064
Louisiana,22039,Evangeline Parish,10357,4208,14879,6149,0.696081726,0.282814705,0.413267021
Louisiana,22041,Franklin Parish,6514,2506,9162,4008,0.710980135,0.273521065,0.43745907
Louisiana,22043,Grant Parish,7406,1181,8819,6225,0.839777753,0.13391541,0.705862343
Louisiana,22045,Iberia Parish,20903,10698,32454,10205,0.644080853,0.329635792,0.314445061
Louisiana,22047,Iberville Parish,7320,8324,16043,-1004,0.456273764,0.518855576,-0.062581812
Louisiana,22049,Jackson Parish,5169,2139,7464,3030,0.692524116,0.286575563,0.405948553
Louisiana,22051,Jefferson Parish,100292,73540,181388,26752,0.552914195,0.405429246,0.147484949
Louisiana,22053,Jefferson Davis Parish,10775,3080,14277,7695,0.754710373,0.215731596,0.538978777
Louisiana,22055,Lafayette Parish,68191,32726,105599,35465,0.645754221,0.309908238,0.335845983
Louisiana,22057,Lafourche Parish,31958,8423,41644,23535,0.767409471,0.202262031,0.56514744
Louisiana,22059,La Salle Parish,5835,605,6568,5230,0.888398295,0.092113276,0.796285019
Louisiana,22061,Lincoln Parish,10761,7102,18664,3659,0.576564509,0.380518646,0.196045863
Louisiana,22063,Livingston Parish,48797,6950,57700,41847,0.845701906,0.120450607,0.725251299
Louisiana,22065,Madison Parish,1927,2744,4732,-817,0.407227388,0.579881657,-0.172654269
Louisiana,22067,Morehouse Parish,6502,5155,11852,1347,0.548599393,0.434947688,0.113651705
Louisiana,22069,Natchitoches Parish,8965,7143,16617,1822,0.539507733,0.429860986,0.109646747
Louisiana,22071,Orleans Parish,24267,133833,165619,-109566,0.146523044,0.808077576,-0.661554532
Louisiana,22073,Ouachita Parish,41712,24420,67987,17292,0.613529057,0.359186315,0.254342742
Louisiana,22075,Plaquemines Parish,6900,3347,10572,3553,0.652667423,0.316590995,0.336076428
Louisiana,22077,Pointe Coupee Parish,6789,4764,11761,2025,0.577246833,0.405067596,0.172179237
Louisiana,22079,Rapides Parish,36814,18318,56838,18496,0.647700482,0.322284387,0.325416095
Louisiana,22081,Red River Parish,2391,1938,4422,453,0.540705563,0.438263229,0.102442334
Louisiana,22083,Richland Parish,6286,3157,9596,3129,0.65506461,0.328991246,0.326073364
Louisiana,22085,Sabine Parish,7877,1703,9785,6174,0.805007665,0.174041901,0.630965764
Louisiana,22087,St. Bernard Parish,10232,4957,15807,5275,0.647308155,0.313595243,0.333712912
Louisiana,22089,St. Charles Parish,16620,8558,26190,8062,0.634593356,0.326765941,0.307827415
Louisiana,22091,St. Helena Parish,2497,3353,5964,-856,0.418678739,0.562206573,-0.143527834
Louisiana,22093,St. James Parish,5456,6418,12085,-962,0.451468763,0.531071576,-0.079602813
Louisiana,22095,St. John the Baptist Parish,7569,12658,20740,-5089,0.364946962,0.610318226,-0.245371264
Louisiana,22097,St. Landry Parish,21966,17208,39970,4758,0.549562172,0.430522892,0.11903928
Louisiana,22099,St. Martin Parish,16872,8266,25749,8606,0.655248748,0.321022176,0.334226572
Louisiana,22101,St. Mary Parish,14353,8050,22871,6303,0.62756329,0.351974116,0.275589174
Louisiana,22103,St. Tammany Parish,90914,27716,124389,63198,0.730884564,0.22281713,0.508067434
Louisiana,22105,Tangipahoa Parish,33933,16869,52381,17064,0.647811229,0.322044253,0.325766976
Louisiana,22107,Tensas Parish,1180,1329,2543,-149,0.464018875,0.522611089,-0.058592214
Louisiana,22109,Terrebonne Parish,31900,10664,43893,21236,0.726767366,0.242954457,0.483812909
Louisiana,22111,Union Parish,7972,2691,10894,5281,0.731778961,0.247016706,0.484762255
Louisiana,22113,Vermilion Parish,19807,4745,25253,15062,0.784342454,0.187898468,0.596443986
Louisiana,22115,Vernon Parish,13471,2665,16633,10806,0.80989599,0.160223652,0.649672338
Louisiana,22117,Washington Parish,12552,5690,18622,6862,0.674041456,0.305552572,0.368488884
Louisiana,22119,Webster Parish,11538,6259,18140,5279,0.636052922,0.345038589,0.291014333
Louisiana,22121,West Baton Rouge Parish,6926,5382,12710,1544,0.544925256,0.423446105,0.121479151
Louisiana,22123,West Carroll Parish,3970,715,4759,3255,0.834208867,0.150241647,0.68396722
Louisiana,22125,West Feliciana Parish,3390,2247,5798,1143,0.584684374,0.38754743,0.197136944
Louisiana,22127,Winn Parish,4605,1643,6368,2962,0.723146985,0.258008794,0.465138191
Massachusetts,25001,Barnstable County,53842,71632,132667,-17790,0.405843201,0.539938342,-0.134095141
Massachusetts,25003,Berkshire County,16799,43540,64507,-26741,0.26042135,0.674965508,-0.414544158
Massachusetts,25005,Bristol County,104775,127619,246068,-22844,0.425796934,0.518633061,-0.092836127
Massachusetts,25007,Dukes County,2474,8338,11434,-5864,0.216372223,0.729228616,-0.512856393
Massachusetts,25009,Essex County,135405,220027,376140,-84622,0.359985644,0.584960387,-0.224974743
Massachusetts,25011,Franklin County,10327,24369,37987,-14042,0.271856161,0.641508937,-0.369652776
Massachusetts,25013,Hampden County,78230,110313,200220,-32083,0.390720208,0.550958945,-0.160238737
Massachusetts,25015,Hampshire County,22089,54572,82329,-32483,0.268301571,0.662852701,-0.39455113
Massachusetts,25017,Middlesex County,216163,508919,767337,-292756,0.281705431,0.6632275,-0.381522069
Massachusetts,25019,Nantucket County,1892,4144,6404,-2252,0.29544035,0.647095565,-0.351655215
Massachusetts,25021,Norfolk County,119171,219129,357781,-99958,0.333083646,0.612466844,-0.279383198
Massachusetts,25023,Plymouth County,114722,133828,264168,-19106,0.434276672,0.506601859,-0.072325187
Massachusetts,25025,Suffolk County,50042,241212,303517,-191170,0.164873796,0.794723195,-0.629849399
Massachusetts,25027,Worcester County,157138,197126,380972,-39988,0.412466008,0.517429102,-0.104963094
Maryland,24001,Allegany County,20025,6665,27804,13360,0.720220112,0.23971371,0.480506402
Maryland,24003,Anne Arundel County,114509,116074,242939,-1565,0.471348775,0.477790721,-0.006441946
Maryland,24005,Baltimore County,131009,189437,335017,-58428,0.391051797,0.565454887,-0.17440309
Maryland,24510,Baltimore city,22726,178562,208980,-155836,0.108747249,0.854445401,-0.745698152
Maryland,24009,Calvert County,24680,16669,43445,8011,0.568074577,0.383680516,0.184394061
Maryland,24011,Caroline County,8999,3747,13282,5252,0.677533504,0.282111128,0.395422376
Maryland,24013,Carroll County,55593,24314,84879,31279,0.65496766,0.286454836,0.368512824
Maryland,24015,Cecil County,27579,12651,42309,14928,0.651847125,0.299014394,0.352832731
Maryland,24017,Charles County,24163,46063,72480,-21900,0.333374724,0.635527042,-0.302152318
Maryland,24019,Dorchester County,7938,5695,14034,2243,0.565626336,0.4058002,0.159826136
Maryland,24021,Frederick County,56472,51891,114962,4581,0.491223187,0.451375237,0.03984795
Maryland,24023,Garrett County,10189,2252,12905,7937,0.789538938,0.174506005,0.615032933
Maryland,24025,Harford County,74261,43803,124224,30458,0.597799137,0.352613022,0.245186115
Maryland,24027,Howard County,44792,93808,146401,-49016,0.305954194,0.640760651,-0.334806457
Maryland,24029,Kent County,4598,4178,9166,420,0.501636483,0.455814968,0.045821515
Maryland,24031,Montgomery County,82985,309761,408300,-226776,0.203245163,0.758660299,-0.555415136
Maryland,24033,Prince George's County,29290,313627,351091,-284337,0.083425665,0.893292622,-0.809866957
Maryland,24035,Queen Anne's County,16211,7316,24633,8895,0.658100922,0.296999959,0.361100963
Maryland,24039,Somerset County,5056,3484,8768,1572,0.576642336,0.397354015,0.179288321
Maryland,24037,St. Mary's County,26889,15786,45169,11103,0.59529766,0.34948748,0.24581018
Maryland,24041,Talbot County,10098,7865,18731,2233,0.539106294,0.419892157,0.119214137
Maryland,24043,Washington County,38842,19193,60731,19649,0.639574517,0.316032998,0.323541519
Maryland,24045,Wicomico County,20832,16327,38722,4505,0.53798874,0.421646609,0.116342131
Maryland,24047,Worcester County,15910,8783,25571,7127,0.622189199,0.34347503,0.278714169
Maine,23001,Androscoggin County,28189,22975,55340,5214,0.509378388,0.415160824,0.094217564
Maine,23003,Aroostook County,19419,13377,34963,6042,0.555415725,0.382604468,0.172811257
Maine,23005,Cumberland County,57697,102935,171249,-45238,0.336918756,0.601083802,-0.264165046
Maine,23007,Franklin County,7900,7001,16382,899,0.482236601,0.427359297,0.054877304
Maine,23009,Hancock County,13682,16107,31983,-2425,0.427789763,0.503611294,-0.075821531
Maine,23011,Kennebec County,31753,29296,65999,2457,0.48111335,0.443885513,0.037227837
Maine,23013,Knox County,9148,12440,23021,-3292,0.397376309,0.540376178,-0.142999869
Maine,23015,Lincoln County,9727,10241,21432,-514,0.45385405,0.477836879,-0.023982829
Maine,23017,Oxford County,16214,12172,31094,4042,0.521451084,0.391458159,0.129992925
Maine,23019,Penobscot County,41601,32832,80228,8769,0.518534676,0.409233684,0.109300992
Maine,23021,Piscataquis County,5403,3098,9144,2305,0.590879265,0.3388014,0.252077865
Maine,23023,Sagadahoc County,9304,10679,21596,-1375,0.430820522,0.49448972,-0.063669198
Maine,23025,Somerset County,14998,9092,25968,5906,0.577556993,0.350123229,0.227433764
Maine,23027,Waldo County,10378,10442,22630,-64,0.458594786,0.46142289,-0.002828104
Maine,23029,Washington County,9037,6358,16559,2679,0.545745516,0.383960384,0.161785132
Maine,23031,York County,50388,55828,113962,-5440,0.442147382,0.489882592,-0.04773521
Michigan,26001,Alcona County,4201,1732,6179,2469,0.679883476,0.280304256,0.39957922
Michigan,26003,Alger County,2585,1663,4513,922,0.572789719,0.368491026,0.204298693
Michigan,26005,Allegan County,33812,17932,55153,15880,0.61305822,0.325131906,0.287926314
Michigan,26007,Alpena County,9090,4877,14688,4213,0.618872549,0.33203976,0.286832789
Michigan,26009,Antrim County,8469,4448,13572,4021,0.624005305,0.327733569,0.296271736
Michigan,26011,Arenac County,4704,2238,7457,2466,0.630816682,0.300120692,0.33069599
Michigan,26013,Baraga County,2158,1156,3486,1002,0.619047619,0.331612163,0.287435456
Michigan,26015,Barry County,19197,9109,30265,10088,0.634297043,0.300974723,0.33332232
Michigan,26017,Bay County,28327,21641,52932,6686,0.535158316,0.408845311,0.126313005
Michigan,26019,Benzie County,5539,4108,10221,1431,0.541923491,0.401917621,0.14000587
Michigan,26021,Berrien County,38646,29496,71882,9150,0.537631118,0.410339167,0.127291951
Michigan,26023,Branch County,11025,4740,16490,6285,0.668587022,0.287446938,0.381140084
Michigan,26025,Calhoun County,31489,24154,58786,7335,0.535654748,0.410880142,0.124774606
Michigan,26027,Cass County,14241,7270,23272,6971,0.611937092,0.312392575,0.299544517
Michigan,26029,Charlevoix County,8674,5137,14567,3537,0.595455482,0.352646393,0.242809089
Michigan,26031,Cheboygan County,8680,4302,13647,4378,0.636037224,0.315234117,0.320803107
Michigan,26033,Chippewa County,9120,5378,15434,3742,0.590903201,0.348451471,0.24245173
Michigan,26035,Clare County,8507,4250,13385,4257,0.635562196,0.317519612,0.318042584
Michigan,26037,Clinton County,21635,16490,40564,5145,0.533354699,0.406518095,0.126836604
Michigan,26039,Crawford County,4354,2110,6833,2244,0.637201815,0.308795551,0.328406264
Michigan,26041,Delta County,11112,6431,18467,4681,0.601721991,0.348242812,0.253479179
Michigan,26043,Dickinson County,8580,3923,13140,4657,0.652968037,0.298554033,0.354414004
Michigan,26045,Eaton County,27608,24534,55686,3074,0.495779909,0.440577524,0.055202385
Michigan,26047,Emmet County,10616,6972,18774,3644,0.565462874,0.371364653,0.194098221
Michigan,26049,Genesee County,84174,102744,196135,-18570,0.429163586,0.523843271,-0.094679685
Michigan,26051,Gladwin County,8124,3794,12472,4330,0.651379089,0.304201411,0.347177678
Michigan,26053,Gogebic County,4019,2925,7313,1094,0.54956926,0.399972651,0.149596609
Michigan,26055,Grand Traverse County,27412,20964,51460,6448,0.532685581,0.407384376,0.125301205
Michigan,26057,Gratiot County,9878,5665,16442,4213,0.600778494,0.344544459,0.256234035
Michigan,26059,Hillsdale County,14094,4799,19880,9295,0.708953722,0.24139839,0.467555332
Michigan,26061,Houghton County,8475,6018,15623,2457,0.542469436,0.385201306,0.15726813
Michigan,26063,Huron County,10629,4579,15848,6050,0.670683998,0.288932357,0.381751641
Michigan,26065,Ingham County,44354,81266,133478,-36912,0.332294461,0.608834415,-0.276539954
Michigan,26067,Ionia County,16374,8206,26364,8168,0.621074192,0.311257776,0.309816416
Michigan,26069,Iosco County,8344,4344,13349,4000,0.625065548,0.325417634,0.299647914
Michigan,26071,Iron County,3675,2004,5910,1671,0.621827411,0.339086294,0.282741117
Michigan,26073,Isabella County,12338,11404,25344,934,0.486821338,0.449968434,0.036852904
Michigan,26075,Jackson County,39793,25795,69567,13998,0.572009717,0.370793623,0.201216094
Michigan,26077,Kalamazoo County,51031,67142,125966,-16111,0.405117254,0.533016846,-0.127899592
Michigan,26079,Kalkaska County,6213,2279,8920,3934,0.696524664,0.255493274,0.44103139
Michigan,26081,Kent County,147959,138567,306270,9392,0.483099879,0.452434127,0.030665752
Michigan,26083,Keweenaw County,814,527,1429,287,0.569629111,0.368789363,0.200839748
Michigan,26085,Lake County,3159,1939,5328,1220,0.592905405,0.363926426,0.228978979
Michigan,26087,Lapeer County,30037,12734,45126,17303,0.665625139,0.282187652,0.383437487
Michigan,26089,Leelanau County,7239,6774,14757,465,0.490546859,0.45903639,0.031510469
Michigan,26091,Lenawee County,26428,16750,45895,9678,0.575836148,0.364963504,0.210872644
Michigan,26093,Livingston County,65665,34378,105577,31287,0.621963117,0.325620163,0.296342954
Michigan,26095,Luce County,1756,681,2576,1075,0.681677019,0.264363354,0.417313665
Michigan,26097,Mackinac County,3740,2085,6088,1655,0.614323259,0.342477004,0.271846255
Michigan,26099,Macomb County,224589,176238,418773,48351,0.536302484,0.420843751,0.115458733
Michigan,26101,Manistee County,6915,4979,12598,1936,0.54889665,0.395221464,0.153675186
Michigan,26103,Marquette County,14646,16042,32897,-1396,0.44520777,0.48764325,-0.04243548
Michigan,26105,Mason County,8505,5281,14658,3224,0.580229226,0.360281075,0.219948151
Michigan,26107,Mecosta County,10305,5827,17149,4478,0.600909674,0.339786576,0.261123098
Michigan,26109,Menominee County,6704,3539,10765,3165,0.622758941,0.328750581,0.29400836
Michigan,26111,Midland County,23877,15655,42379,8222,0.563415843,0.369404658,0.194011185
Michigan,26113,Missaukee County,5386,1565,7301,3821,0.737707163,0.214354198,0.523352965
Michigan,26115,Monroe County,43255,26859,74101,16396,0.583730314,0.362464744,0.22126557
Michigan,26117,Montcalm County,16907,7874,26556,9033,0.636654617,0.296505498,0.340149119
Michigan,26119,Montmorency County,3498,1286,5008,2212,0.698482428,0.256789137,0.441693291
Michigan,26121,Muskegon County,35962,36640,77114,-678,0.466348523,0.475140701,-0.008792178
Michigan,26123,Newaygo County,15174,6212,22605,8962,0.671267419,0.274806459,0.39646096
Michigan,26125,Oakland County,289127,342976,663255,-53849,0.435921327,0.517110312,-0.081188985
Michigan,26127,Oceana County,7228,3973,11903,3255,0.607241872,0.3337814,0.273460472
Michigan,26129,Ogemaw County,6827,3030,10386,3797,0.657327171,0.291738879,0.365588292
Michigan,26131,Ontonagon County,2069,1175,3420,894,0.60497076,0.343567251,0.261403509
Michigan,26133,Osceola County,7336,2705,10597,4631,0.692271398,0.255260923,0.437010475
Michigan,26135,Oscoda County,2843,1044,4062,1799,0.699901526,0.257016248,0.442885278
Michigan,26137,Otsego County,8266,3556,12529,4710,0.659749381,0.283821534,0.375927847
Michigan,26139,Ottawa County,90456,46276,145405,44180,0.622096902,0.318255906,0.303840996
Michigan,26141,Presque Isle County,4486,2400,7215,2086,0.621760222,0.332640333,0.289119889
Michigan,26143,Roscommon County,8141,4287,13036,3854,0.624501381,0.328858546,0.295642835
Michigan,26145,Saginaw County,45469,44395,94198,1074,0.482696023,0.471294507,0.011401516
Michigan,26151,Sanilac County,13446,4873,19243,8573,0.698747597,0.253234943,0.445512654
Michigan,26153,Schoolcraft County,2556,1369,4151,1187,0.61575524,0.329800048,0.285955192
Michigan,26155,Shiawassee County,19232,12547,34044,6685,0.564915991,0.368552462,0.196363529
Michigan,26147,St. Clair County,49067,24553,77994,24514,0.629112496,0.314806267,0.314306229
Michigan,26149,St. Joseph County,14886,7529,23765,7357,0.626383337,0.316810436,0.309572901
Michigan,26157,Tuscola County,17421,7493,26157,9928,0.666016745,0.286462515,0.37955423
Michigan,26159,Van Buren County,17890,13258,33213,4632,0.538644507,0.399181044,0.139463463
Michigan,26161,Washtenaw County,50335,128025,187201,-77690,0.268882111,0.683890578,-0.415008467
Michigan,26163,Wayne County,228908,517842,775450,-288934,0.295193758,0.667795474,-0.372601716
Michigan,26165,Wexford County,10000,4436,15279,5564,0.654493095,0.290333137,0.364159958
Minnesota,27001,Aitkin County,5516,3134,9185,2382,0.600544366,0.341208492,0.259335874
Minnesota,27003,Anoka County,93341,75499,184084,17842,0.507056561,0.410133417,0.096923144
Minnesota,27005,Becker County,10880,5208,17090,5672,0.636629608,0.304739614,0.331889994
Minnesota,27007,Beltrami County,10783,8688,21316,2095,0.50586414,0.40758116,0.09828298
Minnesota,27009,Benton County,12872,5640,19911,7232,0.646476822,0.283260509,0.363216313
Minnesota,27011,Big Stone County,1607,921,2729,686,0.588860388,0.337486259,0.251374129
Minnesota,27013,Blue Earth County,15667,14428,33256,1239,0.471102959,0.433846524,0.037256435
Minnesota,27015,Brown County,8708,3763,13663,4945,0.637341726,0.275415355,0.361926371
Minnesota,27017,Carlton County,8160,8460,18059,-300,0.451852262,0.468464478,-0.016612216
Minnesota,27019,Carver County,29057,21508,55102,7549,0.527331131,0.39033066,0.137000471
Minnesota,27021,Cass County,9982,4949,15885,5033,0.628391564,0.311551778,0.316839786
Minnesota,27023,Chippewa County,3764,1978,6182,1786,0.608864445,0.319961178,0.288903267
Minnesota,27025,Chisago County,18441,9279,30009,9162,0.614515645,0.309207238,0.305308407
Minnesota,27027,Clay County,13549,12974,29108,575,0.465473409,0.44571939,0.019754019
Minnesota,27029,Clearwater County,2925,1100,4225,1825,0.692307692,0.26035503,0.431952662
Minnesota,27031,Cook County,1156,1912,3360,-756,0.344047619,0.569047619,-0.225
Minnesota,27033,Cottonwood County,3679,1678,5697,2001,0.64577848,0.294540986,0.351237494
Minnesota,27035,Crow Wing County,22287,10982,35568,11305,0.626602564,0.308760684,0.31784188
Minnesota,27037,Dakota County,99624,110251,228659,-10627,0.435688077,0.482163396,-0.046475319
Minnesota,27039,Dodge County,6527,3102,10564,3425,0.617853086,0.293638773,0.324214313
Minnesota,27041,Douglas County,13966,6227,21623,7739,0.645886325,0.287980391,0.357905934
Minnesota,27043,Faribault County,4659,2153,7355,2506,0.633446635,0.292726037,0.340720598
Minnesota,27045,Fillmore County,6271,3872,10976,2399,0.571337464,0.352769679,0.218567785
Minnesota,27047,Freeborn County,8808,6041,15929,2767,0.552953732,0.379245401,0.173708331
Minnesota,27049,Goodhue County,14041,9446,25538,4595,0.549808129,0.369880179,0.17992795
Minnesota,27051,Grant County,2063,1104,3453,959,0.597451491,0.319721981,0.27772951
Minnesota,27053,Hennepin County,191768,429283,672644,-237515,0.285095831,0.638202377,-0.353106546
Minnesota,27055,Houston County,5616,4145,10515,1471,0.534094151,0.394198764,0.139895387
Minnesota,27057,Hubbard County,7269,3432,11423,3837,0.63634772,0.300446468,0.335901252
Minnesota,27059,Isanti County,13635,5656,20875,7979,0.653173653,0.270946108,0.382227545
Minnesota,27061,Itasca County,12920,9015,23650,3905,0.546300211,0.381183932,0.165116279
Minnesota,27063,Jackson County,3609,1492,5453,2117,0.661837521,0.273610856,0.388226665
Minnesota,27065,Kanabec County,5230,2327,8125,2903,0.643692308,0.2864,0.357292308
Minnesota,27067,Kandiyohi County,12785,7266,21648,5519,0.590585735,0.335643016,0.254942719
Minnesota,27069,Kittson County,1349,823,2363,526,0.570884469,0.348286077,0.222598392
Minnesota,27071,Koochiching County,3569,2306,6313,1263,0.565341359,0.365277998,0.200063361
Minnesota,27073,Lac qui Parle County,2294,1301,3835,993,0.598174707,0.339243807,0.2589309
Minnesota,27075,Lake County,2932,3077,6472,-145,0.45302843,0.475432633,-0.022404203
Minnesota,27077,Lake of the Woods County,1540,553,2230,987,0.69058296,0.247982063,0.442600897
Minnesota,27079,Le Sueur County,9182,4623,14867,4559,0.617609471,0.310957153,0.306652318
Minnesota,27081,Lincoln County,1930,860,3002,1070,0.64290473,0.286475683,0.356429047
Minnesota,27083,Lyon County,7256,3825,12129,3431,0.598235634,0.315359881,0.282875753
Minnesota,27087,Mahnomen County,991,930,2074,61,0.477820636,0.448408872,0.029411764
Minnesota,27089,Marshall County,3208,1225,4794,1983,0.669169796,0.255527743,0.413642053
Minnesota,27091,Martin County,7062,2733,10469,4329,0.674562996,0.261056452,0.413506544
Minnesota,27085,McLeod County,12155,4978,18684,7177,0.650556626,0.266431171,0.384125455
Minnesota,27093,Meeker County,8103,3192,12198,4911,0.664289228,0.261682243,0.402606985
Minnesota,27095,Mille Lacs County,8340,3709,12948,4631,0.644114921,0.286453506,0.357661415
Minnesota,27097,Morrison County,12925,3637,17534,9288,0.737139272,0.207425573,0.529713699
Minnesota,27099,Mower County,8826,7444,17587,1382,0.501847956,0.423267186,0.07858077
Minnesota,27101,Murray County,2974,1295,4642,1679,0.640672124,0.27897458,0.361697544
Minnesota,27103,Nicollet County,8436,7886,17914,550,0.470916602,0.440214357,0.030702245
Minnesota,27105,Nobles County,5299,2733,8592,2566,0.616736499,0.318086592,0.298649907
Minnesota,27107,Norman County,1699,1264,3232,435,0.525680693,0.391089109,0.134591584
Minnesota,27109,Olmsted County,35668,36266,79277,-598,0.449916117,0.457459288,-0.007543171
Minnesota,27111,Otter Tail County,20939,9339,32284,11600,0.648587536,0.289276422,0.359311114
Minnesota,27113,Pennington County,4000,2146,6671,1854,0.599610253,0.321690901,0.277919352
Minnesota,27115,Pine County,8191,4580,13729,3611,0.596620293,0.333600408,0.263019885
Minnesota,27117,Pipestone County,3338,1127,4779,2211,0.698472484,0.235823394,0.46264909
Minnesota,27119,Polk County,8979,4712,14698,4267,0.610899442,0.320587835,0.290311607
Minnesota,27121,Pope County,3793,2106,6294,1687,0.602637432,0.334604385,0.268033047
Minnesota,27123,Ramsey County,70778,176929,269161,-106151,0.262957858,0.657335201,-0.394377343
Minnesota,27125,Red Lake County,1141,540,1871,601,0.609834313,0.288615714,0.321218599
Minnesota,27127,Redwood County,5137,1887,7566,3250,0.678958499,0.249405234,0.429553265
Minnesota,27129,Renville County,4890,2117,7563,2773,0.646568822,0.279915377,0.366653445
Minnesota,27131,Rice County,15429,14437,32217,992,0.478908651,0.448117454,0.030791197
Minnesota,27133,Rock County,3091,1373,4807,1718,0.643020595,0.28562513,0.357395465
Minnesota,27135,Roseau County,5451,1856,7767,3595,0.701815373,0.238959701,0.462855672
Minnesota,27139,Scott County,39948,28502,74390,11446,0.537007662,0.383142896,0.153864766
Minnesota,27141,Sherburne County,31049,13299,47938,17750,0.647690767,0.277420835,0.370269932
Minnesota,27143,Sibley County,5193,1954,7727,3239,0.672059014,0.252879513,0.419179501
Minnesota,27137,St. Louis County,44631,57769,111260,-13138,0.40114147,0.519225238,-0.118083768
Minnesota,27145,Stearns County,47618,25575,78985,22043,0.602873963,0.323795657,0.279078306
Minnesota,27147,Steele County,11198,6239,19040,4959,0.588130252,0.327678571,0.260451681
Minnesota,27149,Stevens County,2800,2116,5350,684,0.523364486,0.395514019,0.127850467
Minnesota,27151,Swift County,2962,1679,4968,1283,0.596215781,0.337962963,0.258252818
Minnesota,27153,Todd County,8485,2783,11944,5702,0.710398526,0.233004019,0.477394507
Minnesota,27155,Traverse County,1050,631,1791,419,0.586264657,0.352317141,0.233947516
Minnesota,27157,Wabasha County,6989,3866,11764,3123,0.594100646,0.328629718,0.265470928
Minnesota,27159,Wadena County,4837,1684,6894,3153,0.701624601,0.24427038,0.457354221
Minnesota,27161,Waseca County,5967,2838,9579,3129,0.622925149,0.296273097,0.326652052
Minnesota,27163,Washington County,64429,67086,142843,-2657,0.451047654,0.469648495,-0.018600841
Minnesota,27165,Watonwan County,2768,1814,4971,954,0.556829612,0.364916516,0.191913096
Minnesota,27167,Wilkin County,2129,893,3279,1236,0.649283318,0.272339128,0.37694419
Minnesota,27169,Winona County,12122,11366,25852,756,0.468899892,0.439656506,0.029243386
Minnesota,27171,Wright County,43274,20336,69154,22938,0.62576279,0.294068311,0.331694479
Minnesota,27173,Yellow Medicine County,3382,1524,5253,1858,0.643822578,0.290119931,0.353702647
Missouri,29001,Adair County,6019,3495,10137,2524,0.593765414,0.344776561,0.248988853
Missouri,29003,Andrew County,6665,2045,9140,4620,0.729212254,0.223741794,0.50547046
Missouri,29005,Atchison County,2059,541,2723,1518,0.756151304,0.198677929,0.557473375
Missouri,29007,Audrain County,6981,2567,10043,4414,0.695111023,0.255600916,0.439510107
Missouri,29009,Barry County,11427,2710,14604,8717,0.782456861,0.185565598,0.596891263
Missouri,29011,Barton County,4958,795,5932,4163,0.835805799,0.134018881,0.701786918
Missouri,29013,Bates County,6000,1617,8021,4383,0.748036404,0.201595811,0.546440593
Missouri,29015,Benton County,7212,2024,9584,5188,0.752504174,0.211185309,0.541318865
Missouri,29017,Bollinger County,4827,705,5669,4122,0.851472923,0.124360557,0.727112366
Missouri,29019,Boone County,36146,41072,83312,-4926,0.433863069,0.492990205,-0.059127136
Missouri,29021,Buchanan County,21315,12010,35563,9305,0.599358884,0.337710542,0.261648342
Missouri,29023,Butler County,13647,3036,17232,10611,0.791956825,0.176183844,0.615772981
Missouri,29025,Caldwell County,3231,837,4309,2394,0.749825946,0.194244604,0.555581342
Missouri,29027,Callaway County,13052,4988,19127,8064,0.682386156,0.260783186,0.42160297
Missouri,29029,Camden County,16721,4706,22182,12015,0.753809395,0.212153999,0.541655396
Missouri,29031,Cape Girardeau County,26939,8468,36875,18471,0.730549153,0.229640678,0.500908475
Missouri,29033,Carroll County,3480,745,4361,2735,0.797982114,0.170832378,0.627149736
Missouri,29035,Carter County,2323,436,2842,1887,0.817382125,0.153413089,0.663969036
Missouri,29037,Cass County,33006,14816,50715,18190,0.650813369,0.292142364,0.358671005
Missouri,29039,Cedar County,5019,1010,6278,4009,0.799458426,0.160879261,0.638579165
Missouri,29041,Chariton County,2948,888,3962,2060,0.744068652,0.224129228,0.519939424
Missouri,29043,Christian County,30941,8505,41394,22436,0.74747548,0.20546456,0.54201092
Missouri,29045,Clark County,2458,724,3316,1734,0.741254524,0.218335344,0.52291918
Missouri,29047,Clay County,57328,45182,109237,12146,0.524803867,0.413614435,0.111189432
Missouri,29049,Clinton County,7058,2572,10197,4486,0.692164362,0.252231048,0.439933314
Missouri,29051,Cole County,24610,10907,37261,13703,0.660476101,0.292718929,0.367757172
Missouri,29053,Cooper County,5623,1932,7976,3691,0.70498997,0.24222668,0.46276329
Missouri,29055,Crawford County,7724,1824,9920,5900,0.778629032,0.183870968,0.594758064
Missouri,29057,Dade County,3184,637,3951,2547,0.805871931,0.161225006,0.644646925
Missouri,29059,Dallas County,5895,1271,7440,4624,0.79233871,0.170833333,0.621505377
Missouri,29061,Daviess County,2763,730,3689,2033,0.748983464,0.197885606,0.551097858
Missouri,29063,DeKalb County,3540,824,4590,2716,0.77124183,0.179520697,0.591721133
Missouri,29065,Dent County,5599,978,6778,4621,0.826054883,0.144290351,0.681764532
Missouri,29067,Douglas County,5486,984,6664,4502,0.823229292,0.147659064,0.675570228
Missouri,29069,Dunklin County,8026,2360,10574,5666,0.759031587,0.223188954,0.535842633
Missouri,29071,Franklin County,35420,12339,50045,23081,0.707763013,0.246558098,0.461204915
Missouri,29073,Gasconade County,5670,1519,7444,4151,0.761687265,0.204056959,0.557630306
Missouri,29075,Gentry County,2304,605,3033,1699,0.759643917,0.19947247,0.560171447
Missouri,29077,Greene County,77387,42400,127609,34987,0.606438417,0.332264966,0.274173451
Missouri,29079,Grundy County,3462,780,4413,2682,0.78450034,0.17675051,0.60774983
Missouri,29081,Harrison County,2965,574,3682,2391,0.805268876,0.155893536,0.64937534
Missouri,29083,Henry County,7072,2356,9855,4716,0.717605277,0.239066464,0.478538813
Missouri,29085,Hickory County,3539,1016,4717,2523,0.750264999,0.215391138,0.534873861
Missouri,29087,Holt County,1926,346,2348,1580,0.820272572,0.147359455,0.672913117
Missouri,29089,Howard County,3277,1279,4851,1998,0.675530818,0.263656978,0.41187384
Missouri,29091,Howell County,13888,2880,17415,11008,0.797473442,0.165374677,0.632098765
Missouri,29093,Iron County,3173,933,4260,2240,0.744835681,0.219014085,0.525821596
Missouri,29095,Jackson County,114777,163723,294063,-48946,0.39031432,0.556761646,-0.166447326
Missouri,29097,Jasper County,35058,10565,48179,24493,0.727661429,0.219286411,0.508375018
Missouri,29099,Jefferson County,68973,31546,105969,37427,0.650879031,0.297690834,0.353188197
Missouri,29101,Johnson County,13702,5924,21087,7778,0.649784227,0.28093138,0.368852847
Missouri,29103,Knox County,1413,379,1867,1034,0.756829138,0.202999464,0.553829674
Missouri,29105,Laclede County,12834,2543,15959,10291,0.804185726,0.159345824,0.644839902
Missouri,29107,Lafayette County,10977,4047,15815,6930,0.694087891,0.255896301,0.43819159
Missouri,29109,Lawrence County,13084,2898,16674,10186,0.784694734,0.173803526,0.610891208
Missouri,29111,Lewis County,3343,933,4452,2410,0.750898473,0.209568733,0.54132974
Missouri,29113,Lincoln County,18111,5561,24857,12550,0.728607636,0.223719677,0.504887959
Missouri,29115,Linn County,4084,1239,5572,2845,0.732950467,0.222361809,0.510588658
Missouri,29117,Livingston County,4879,1265,6408,3614,0.76139201,0.197409488,0.563982522
Missouri,29121,Macon County,5794,1518,7579,4276,0.764480802,0.200290276,0.564190526
Missouri,29123,Madison County,4102,1005,5318,3097,0.77134261,0.18898082,0.58236179
Missouri,29125,Maries County,3559,794,4498,2765,0.791240551,0.176522899,0.614717652
Missouri,29127,Marion County,9418,2993,12902,6425,0.729964347,0.231979538,0.497984809
Missouri,29119,McDonald County,6599,1329,8233,5270,0.801530426,0.161423539,0.640106887
Missouri,29129,Mercer County,1486,216,1739,1270,0.854514089,0.124209316,0.730304773
Missouri,29131,Miller County,9285,1750,11414,7535,0.81347468,0.153320484,0.660154196
Missouri,29133,Mississippi County,3600,1458,5165,2142,0.696999032,0.282284608,0.414714424
Missouri,29135,Moniteau County,5344,1237,6808,4107,0.784958872,0.181698002,0.60326087
Missouri,29137,Monroe County,3159,853,4147,2306,0.761755486,0.205690861,0.556064625
Missouri,29139,Montgomery County,4124,1118,5424,3006,0.760324484,0.206120944,0.55420354
Missouri,29141,Morgan County,6757,1768,8815,4989,0.766534317,0.200567215,0.565967102
Missouri,29143,New Madrid County,5270,1933,7352,3337,0.716811752,0.262921654,0.453890098
Missouri,29145,Newton County,20546,4988,26506,15558,0.77514525,0.188183807,0.586961443
Missouri,29147,Nodaway County,6379,2529,9439,3850,0.675813116,0.267930925,0.407882191
Missouri,29149,Oregon County,3668,865,4664,2803,0.7864494,0.185463122,0.600986278
Missouri,29151,Osage County,5845,998,7078,4847,0.825798248,0.141000283,0.684797965
Missouri,29153,Ozark County,3639,724,4501,2915,0.808487003,0.160853144,0.647633859
Missouri,29155,Pemiscot County,3964,1946,6025,2018,0.657925311,0.322987552,0.334937759
Missouri,29157,Perry County,6907,1520,8732,5387,0.790998626,0.174072377,0.616926249
Missouri,29159,Pettis County,12792,4322,18045,8470,0.708894431,0.23951233,0.469382101
Missouri,29161,Phelps County,12699,4761,18499,7938,0.686469539,0.257365263,0.429104276
Missouri,29163,Pike County,5274,1806,7375,3468,0.715118644,0.244881356,0.470237288
Missouri,29165,Platte County,24975,18915,46641,6060,0.535473082,0.405544478,0.129928604
Missouri,29167,Polk County,10435,2630,13709,7805,0.761178788,0.191844774,0.569334014
Missouri,29169,Pulaski County,9870,2918,13443,6952,0.734211114,0.217064643,0.517146471
Missouri,29171,Putnam County,1936,352,2342,1584,0.826643894,0.15029889,0.676345004
Missouri,29173,Ralls County,3969,1138,5266,2831,0.753703,0.216103304,0.537599696
Missouri,29175,Randolph County,7529,2283,10309,5246,0.730332719,0.221456979,0.50887574
Missouri,29177,Ray County,7103,3088,10835,4015,0.655560683,0.285002307,0.370558376
Missouri,29179,Reynolds County,2402,540,3032,1862,0.792216359,0.178100264,0.614116095
Missouri,29181,Ripley County,4520,830,5518,3690,0.819137369,0.150416818,0.668720551
Missouri,29195,Saline County,5977,2787,9245,3190,0.646511628,0.301460249,0.345051379
Missouri,29197,Schuyler County,1505,354,1933,1151,0.778582514,0.183135023,0.595447491
Missouri,29199,Scotland County,1525,365,1968,1160,0.774898374,0.18546748,0.589430894
Missouri,29201,Scott County,13168,3574,17244,9594,0.763627929,0.207260496,0.556367433
Missouri,29203,Shannon County,2966,776,3904,2190,0.759733607,0.198770492,0.560963115
Missouri,29205,Shelby County,2524,606,3252,1918,0.776137761,0.186346863,0.589790898
Missouri,29183,St. Charles County,120899,68225,199513,52674,0.605970538,0.341957667,0.264012871
Missouri,29185,St. Clair County,3501,936,4630,2565,0.756155508,0.202159827,0.553995681
Missouri,29187,St. Francois County,17467,6250,24714,11217,0.706765396,0.252893097,0.453872299
Missouri,29189,St. Louis County,199081,280866,503493,-81785,0.395399737,0.557834965,-0.162435228
Missouri,29510,St. Louis city,20281,101487,127403,-81206,0.159187774,0.796582498,-0.637394724
Missouri,29186,Ste. Genevieve County,5495,2540,8459,2955,0.649603972,0.3002719,0.349332072
Missouri,29207,Stoddard County,11077,1873,13278,9204,0.834237084,0.141060401,0.693176683
Missouri,29209,Stone County,13149,2886,16538,10263,0.795078002,0.174507196,0.620570806
Missouri,29211,Sullivan County,1884,526,2484,1358,0.758454106,0.211755233,0.546698873
Missouri,29213,Taney County,18240,4367,23399,13873,0.779520492,0.186631907,0.592888585
Missouri,29215,Texas County,8875,1728,10935,7147,0.811614083,0.158024691,0.653589392
Missouri,29217,Vernon County,6526,1706,8576,4820,0.760960821,0.198927239,0.562033582
Missouri,29219,Warren County,11109,3915,15766,7194,0.704617531,0.248319168,0.456298363
Missouri,29221,Washington County,7047,1926,9279,5121,0.759456838,0.20756547,0.551891368
Missouri,29223,Wayne County,4640,946,5738,3694,0.808644127,0.164865807,0.64377832
Missouri,29225,Webster County,12829,3173,16690,9656,0.768663871,0.190113841,0.57855003
Missouri,29227,Worth County,808,195,1046,613,0.772466539,0.186424474,0.586042065
Missouri,29229,Wright County,6703,1166,8086,5537,0.828963641,0.144199852,0.684763789
Mississippi,28001,Adams County,5125,6921,12214,-1796,0.419600458,0.566644834,-0.147044376
Mississippi,28003,Alcorn County,11817,2684,14781,9133,0.799472296,0.181584467,0.617887829
Mississippi,28005,Amite County,4282,2688,7033,1594,0.608844021,0.382198208,0.226645813
Mississippi,28007,Attala County,4288,2847,7242,1441,0.592101629,0.393123447,0.198978182
Mississippi,28009,Benton County,2240,1713,3996,527,0.560560561,0.428678679,0.131881882
Mississippi,28011,Bolivar County,4251,8410,12831,-4159,0.331306991,0.655443847,-0.324136856
Mississippi,28013,Calhoun County,4360,1884,6339,2476,0.687805648,0.297207761,0.390597887
Mississippi,28015,Carroll County,3774,1648,5470,2126,0.689945155,0.301279707,0.388665448
Mississippi,28017,Chickasaw County,4127,3649,7890,478,0.523067174,0.462484157,0.060583017
Mississippi,28019,Choctaw County,2763,1198,4020,1565,0.687313433,0.29800995,0.389303483
Mississippi,28021,Claiborne County,414,2523,2954,-2109,0.140148951,0.854096141,-0.71394719
Mississippi,28023,Clarke County,5088,2556,7713,2532,0.6596655,0.331388565,0.328276935
Mississippi,28025,Clay County,4136,5695,9960,-1559,0.415261044,0.571787149,-0.156526105
Mississippi,28027,Coahoma County,2426,6378,8912,-3952,0.272217235,0.715664273,-0.443447038
Mississippi,28029,Copiah County,5576,6203,11906,-627,0.468335293,0.520997816,-0.052662523
Mississippi,28031,Covington County,5423,3267,8790,2156,0.616951081,0.371672355,0.245278726
Mississippi,28033,DeSoto County,42155,19892,64022,22263,0.658445534,0.310705695,0.347739839
Mississippi,28035,Forrest County,15149,11271,27284,3878,0.555233837,0.413099252,0.142134585
Mississippi,28037,Franklin County,2685,1471,4219,1214,0.636406731,0.34866082,0.287745911
Mississippi,28039,George County,8652,1013,9831,7639,0.880073238,0.1030414,0.777031838
Mississippi,28041,Greene County,4309,956,5325,3353,0.809201878,0.179530516,0.629671362
Mississippi,28043,Grenada County,5940,4386,10442,1554,0.568856541,0.420034476,0.148822065
Mississippi,28045,Hancock County,13720,3320,17517,10400,0.783239139,0.189530171,0.593708968
Mississippi,28047,Harrison County,39710,20679,62076,19031,0.639699723,0.333123913,0.30657581
Mississippi,28049,Hinds County,24919,64922,91536,-40003,0.27223169,0.709251005,-0.437019315
Mississippi,28051,Holmes County,1151,5820,7045,-4669,0.163378282,0.826117814,-0.662739532
Mississippi,28053,Humphreys County,924,2652,3599,-1728,0.256737983,0.736871353,-0.48013337
Mississippi,28055,Issaquena County,298,395,699,-97,0.426323319,0.56509299,-0.138769671
Mississippi,28057,Itawamba County,8385,1100,9634,7285,0.870354993,0.11417895,0.756176043
Mississippi,28059,Jackson County,31204,13087,45465,18117,0.686330144,0.287847795,0.398482349
Mississippi,28061,Jasper County,4032,4367,8468,-335,0.476145489,0.515706188,-0.039560699
Mississippi,28063,Jefferson County,489,3337,3859,-2848,0.126716766,0.864731796,-0.73801503
Mississippi,28065,Jefferson Davis County,2466,3720,6237,-1254,0.395382395,0.596440596,-0.201058201
Mississippi,28067,Jones County,20076,7748,28250,12328,0.710654867,0.274265487,0.43638938
Mississippi,28069,Kemper County,1778,2827,4639,-1049,0.383272257,0.609398577,-0.22612632
Mississippi,28071,Lafayette County,10872,7968,19642,2904,0.553507789,0.405661338,0.147846451
Mississippi,28073,Lamar County,18493,5044,24179,13449,0.764837255,0.208610778,0.556226477
Mississippi,28075,Lauderdale County,17574,10910,28967,6664,0.606690372,0.376635482,0.23005489
Mississippi,28077,Lawrence County,4072,2181,6329,1891,0.643387581,0.344604203,0.298783378
Mississippi,28079,Leake County,4775,3579,8436,1196,0.566026553,0.424253201,0.141773352
Mississippi,28081,Lee County,21695,9635,31974,12060,0.678520048,0.301338588,0.37718146
Mississippi,28083,Leflore County,2757,6677,9566,-3920,0.288208238,0.697992891,-0.409784653
Mississippi,28085,Lincoln County,10550,4458,15193,6092,0.694398736,0.293424603,0.400974133
Mississippi,28087,Lowndes County,13124,11545,25139,1579,0.522057361,0.459246589,0.062810772
Mississippi,28089,Madison County,25607,18358,45048,7249,0.56843811,0.407520867,0.160917243
Mississippi,28091,Marion County,7697,3572,11443,4125,0.672638294,0.312155903,0.360482391
Mississippi,28093,Marshall County,6525,7944,14698,-1419,0.443937951,0.540481698,-0.096543747
Mississippi,28095,Monroe County,10107,5485,15781,4622,0.64045371,0.347569862,0.292883848
Mississippi,28097,Montgomery County,2334,1775,4162,559,0.560788083,0.426477655,0.134310428
Mississippi,28099,Neshoba County,7613,2668,10438,4945,0.729354282,0.255604522,0.47374976
Mississippi,28101,Newton County,5929,2549,8594,3380,0.68989993,0.296602281,0.393297649
Mississippi,28103,Noxubee County,1181,4330,5538,-3149,0.213253882,0.781870711,-0.568616829
Mississippi,28105,Oktibbeha County,7671,7851,16151,-180,0.474955111,0.486099932,-0.011144821
Mississippi,28107,Panola County,7371,7300,14854,71,0.496229972,0.491450114,0.004779858
Mississippi,28109,Pearl River County,15530,2919,18893,12611,0.821997565,0.154501667,0.667495898
Mississippi,28111,Perry County,4135,1220,5432,2915,0.76122975,0.224594993,0.536634757
Mississippi,28113,Pike County,7748,7636,15633,112,0.495618243,0.488453912,0.007164331
Mississippi,28115,Pontotoc County,9442,2123,11811,7319,0.799424266,0.179747693,0.619676573
Mississippi,28117,Prentiss County,7647,2067,9871,5580,0.774693547,0.209401276,0.565292271
Mississippi,28119,Quitman County,998,2303,3353,-1305,0.297643901,0.686847599,-0.389203698
Mississippi,28121,Rankin County,46168,13741,61356,32427,0.752461047,0.223955277,0.52850577
Mississippi,28123,Scott County,5742,3999,9867,1743,0.581939799,0.405290362,0.176649437
Mississippi,28125,Sharkey County,619,1290,1926,-671,0.321391485,0.669781931,-0.348390446
Mississippi,28127,Simpson County,7393,3871,11416,3522,0.64759986,0.339085494,0.308514366
Mississippi,28129,Smith County,5877,1598,7556,4279,0.777792483,0.21148756,0.566304923
Mississippi,28131,Stone County,4810,1400,6368,3410,0.755339196,0.219849246,0.53548995
Mississippi,28133,Sunflower County,2768,6560,9406,-3792,0.294280247,0.697427174,-0.403146927
Mississippi,28135,Tallahatchie County,2462,3337,5870,-875,0.419420784,0.568483816,-0.149063032
Mississippi,28137,Tate County,7385,3804,11389,3581,0.648432698,0.334006497,0.314426201
Mississippi,28139,Tippah County,7182,1808,9143,5374,0.785518976,0.19774691,0.587772066
Mississippi,28141,Tishomingo County,7117,990,8310,6127,0.856438026,0.119133574,0.737304452
Mississippi,28143,Tunica County,840,2577,3463,-1737,0.242564251,0.744152469,-0.501588218
Mississippi,28145,Union County,9161,1969,11374,7192,0.805433445,0.17311412,0.632319325
Mississippi,28147,Walthall County,3374,2475,5909,899,0.5709934,0.418852598,0.152140802
Mississippi,28149,Warren County,9420,8518,18287,902,0.515120031,0.465795374,0.049324657
Mississippi,28151,Washington County,4541,9847,14571,-5306,0.311646421,0.675794386,-0.364147965
Mississippi,28153,Wayne County,5957,3493,9534,2464,0.624816446,0.366372981,0.258443465
Mississippi,28155,Webster County,3949,1001,5024,2948,0.78602707,0.199243631,0.586783439
Mississippi,28157,Wilkinson County,1305,2826,4174,-1521,0.312649736,0.677048395,-0.364398659
Mississippi,28159,Winston County,4874,3778,8771,1096,0.555694904,0.430737658,0.124957246
Mississippi,28161,Yalobusha County,3366,2574,6058,792,0.55562892,0.424892704,0.130736216
Mississippi,28163,Yazoo County,4568,5221,9892,-653,0.461787303,0.527800243,-0.06601294
Montana,30001,Beaverhead County,3243,1115,4676,2128,0.693541488,0.238451668,0.45508982
Montana,30003,Big Horn County,1833,2061,4148,-228,0.441899711,0.496865959,-0.054966248
Montana,30005,Blaine County,1259,1187,2621,72,0.480351011,0.45288058,0.027470431
Montana,30007,Broadwater County,2329,566,3097,1763,0.752018082,0.182757507,0.569260575
Montana,30009,Carbon County,3729,1824,5923,1905,0.629579605,0.307952051,0.321627554
Montana,30011,Carter County,677,70,777,607,0.871299871,0.09009009,0.781209781
Montana,30013,Cascade County,19343,12053,33791,7290,0.572430529,0.35669261,0.215737919
Montana,30015,Chouteau County,1676,729,2571,947,0.651886426,0.283547258,0.368339168
Montana,30017,Custer County,3638,1172,5145,2466,0.707094266,0.227793975,0.479300291
Montana,30019,Daniels County,729,167,952,562,0.765756303,0.175420168,0.590336135
Montana,30021,Dawson County,3298,786,4297,2512,0.767512218,0.182918315,0.584593903
Montana,30023,Deer Lodge County,1736,2018,4099,-282,0.423517931,0.492315199,-0.068797268
Montana,30025,Fallon County,1276,154,1474,1122,0.865671642,0.104477612,0.76119403
Montana,30027,Fergus County,4235,1196,5782,3039,0.732445521,0.206848841,0.52559668
Montana,30029,Flathead County,30079,13233,46144,16846,0.651850728,0.286776179,0.365074549
Montana,30031,Gallatin County,23360,23879,52169,-519,0.447775499,0.457723936,-0.009948437
Montana,30033,Garfield County,653,34,715,619,0.913286713,0.047552448,0.865734265
Montana,30035,Glacier County,1598,3076,4969,-1478,0.321593882,0.619038036,-0.297444154
Montana,30037,Golden Valley County,365,71,468,294,0.77991453,0.151709402,0.628205128
Montana,30039,Granite County,1185,469,1762,716,0.672531215,0.266174801,0.406356414
Montana,30041,Hill County,3446,2350,6347,1096,0.542933669,0.370253663,0.172680006
Montana,30043,Jefferson County,4099,1975,6535,2124,0.62723795,0.302218822,0.325019128
Montana,30045,Judith Basin County,867,232,1189,635,0.729184188,0.195121951,0.534062237
Montana,30047,Lake County,7453,4703,12898,2750,0.577841526,0.364630175,0.213211351
Montana,30049,Lewis and Clark County,16665,14331,33697,2334,0.494554411,0.425290085,0.069264326
Montana,30051,Liberty County,695,205,949,490,0.732349842,0.21601686,0.516332982
Montana,30053,Lincoln County,6720,2040,9250,4680,0.726486486,0.220540541,0.505945945
Montana,30057,Madison County,3280,1175,4708,2105,0.696686491,0.249575191,0.4471113
Montana,30055,McCone County,858,154,1056,704,0.8125,0.145833333,0.666666667
Montana,30059,Meagher County,728,191,970,537,0.750515464,0.196907216,0.553608248
Montana,30061,Mineral County,1322,515,1974,807,0.66970618,0.260891591,0.408814589
Montana,30063,Missoula County,21699,30740,57271,-9041,0.378882855,0.536746346,-0.157863491
Montana,30065,Musselshell County,1961,331,2404,1630,0.815723794,0.137687188,0.678036606
Montana,30067,Park County,4872,3521,9056,1351,0.537985866,0.388803004,0.149182862
Montana,30069,Petroleum County,276,30,319,246,0.865203762,0.094043887,0.771159875
Montana,30071,Phillips County,1715,315,2147,1400,0.798789008,0.146716348,0.65207266
Montana,30073,Pondera County,1786,737,2692,1049,0.663447251,0.273774146,0.389673105
Montana,30075,Powder River County,880,127,1047,753,0.840496657,0.121298949,0.719197708
Montana,30077,Powell County,2017,549,2768,1468,0.728684971,0.19833815,0.530346821
Montana,30079,Prairie County,555,100,686,455,0.809037901,0.145772595,0.663265306
Montana,30081,Ravalli County,14673,6166,22063,8507,0.665050084,0.27947242,0.385577664
Montana,30083,Richland County,3885,669,4812,3216,0.807356608,0.139027431,0.668329177
Montana,30085,Roosevelt County,1722,1504,3486,218,0.493975904,0.431440046,0.062535858
Montana,30087,Rosebud County,2211,969,3357,1242,0.658623771,0.288650581,0.36997319
Montana,30089,Sanders County,4268,1211,5871,3057,0.726963039,0.206268097,0.520694942
Montana,30091,Sheridan County,1237,476,1825,761,0.677808219,0.260821918,0.416986301
Montana,30093,Silver Bow County,6252,8545,16122,-2293,0.387793078,0.530021089,-0.142228011
Montana,30095,Stillwater County,3630,904,4816,2726,0.753737542,0.187707641,0.566029901
Montana,30097,Sweet Grass County,1580,398,2077,1182,0.760712566,0.191622532,0.569090034
Montana,30099,Teton County,2152,803,3143,1349,0.68469615,0.255488387,0.429207763
Montana,30101,Toole County,1495,399,2018,1096,0.740832507,0.197720515,0.543111992
Montana,30103,Treasure County,350,59,441,291,0.793650794,0.133786848,0.659863946
Montana,30105,Valley County,2697,886,3860,1811,0.698704663,0.229533679,0.469170984
Montana,30107,Wheatland County,698,179,932,519,0.748927039,0.192060086,0.556866953
Montana,30109,Wibaux County,460,55,533,405,0.8630394,0.103189493,0.759849907
Montana,30111,Yellowstone County,38675,21117,64675,17558,0.59798995,0.32650947,0.27148048
North Carolina,37001,Alamance County,38235,29268,69264,8967,0.552018365,0.422557173,0.129461192
North Carolina,37003,Alexander County,13826,3750,18011,10076,0.767641997,0.208206096,0.559435901
North Carolina,37005,Alleghany County,3789,1300,5214,2489,0.726697353,0.24932873,0.477368623
North Carolina,37007,Anson County,4480,5785,10394,-1305,0.431017895,0.556571099,-0.125553204
North Carolina,37009,Ashe County,9353,3476,13160,5877,0.710714286,0.264133739,0.446580547
North Carolina,37011,Avery County,6226,1670,8060,4556,0.772456576,0.20719603,0.565260546
North Carolina,37013,Beaufort County,14478,8699,23599,5779,0.613500572,0.368617314,0.244883258
North Carolina,37015,Bertie County,3476,5837,9380,-2361,0.370575693,0.62228145,-0.251705757
North Carolina,37017,Bladen County,8511,7021,15743,1490,0.540621228,0.445975989,0.094645239
North Carolina,37019,Brunswick County,42440,23117,67255,19323,0.63103115,0.343721656,0.287309494
North Carolina,37021,Buncombe County,55339,74937,134507,-19598,0.411420967,0.557123421,-0.145702454
North Carolina,37023,Burke County,25741,10930,37638,14811,0.683909878,0.290398002,0.393511876
North Carolina,37025,Cabarrus County,53224,35048,91002,18176,0.584866267,0.385134393,0.199731874
North Carolina,37027,Caldwell County,26499,8403,35747,18096,0.741292976,0.235068677,0.506224299
North Carolina,37029,Camden County,3527,1266,4939,2261,0.714112168,0.256327192,0.457784976
North Carolina,37031,Carteret County,26228,9806,36919,16422,0.710420109,0.265608494,0.444811615
North Carolina,37033,Caswell County,5758,4549,10515,1209,0.547598669,0.432620067,0.114978602
North Carolina,37035,Catawba County,48062,21050,71065,27012,0.67631042,0.296207697,0.380102723
North Carolina,37037,Chatham County,17012,20953,39080,-3941,0.43531218,0.536156602,-0.100844422
North Carolina,37039,Cherokee County,10711,2809,13860,7902,0.772799423,0.202669553,0.57012987
North Carolina,37041,Chowan County,3983,2965,7108,1018,0.56035453,0.417135622,0.143218908
North Carolina,37043,Clay County,4395,1352,5885,3043,0.746813934,0.229736619,0.517077315
North Carolina,37045,Cleveland County,28394,14896,44137,13498,0.643315132,0.337494619,0.305820513
North Carolina,37047,Columbus County,14177,8991,23472,5186,0.603996251,0.383052147,0.220944104
North Carolina,37049,Craven County,27556,17481,46231,10075,0.596050269,0.378122905,0.217927364
North Carolina,37051,Cumberland County,50593,70523,124402,-19930,0.406689603,0.566896031,-0.160206428
North Carolina,37053,Currituck County,9070,2879,12423,6191,0.7300974,0.231747565,0.498349835
North Carolina,37055,Dare County,11283,7079,19009,4204,0.593560945,0.372402546,0.221158399
North Carolina,37057,Davidson County,52870,17328,72013,35542,0.734172997,0.240623221,0.493549776
North Carolina,37059,Davie County,15502,5228,21350,10274,0.726088993,0.244871194,0.481217799
North Carolina,37061,Duplin County,12151,8196,20601,3955,0.589825737,0.397844765,0.191980972
North Carolina,37063,Durham County,27879,118783,150543,-90904,0.185189614,0.789030377,-0.603840763
North Carolina,37065,Edgecombe County,8219,16152,24653,-7933,0.333387417,0.655173813,-0.321786396
North Carolina,37067,Forsyth County,74793,92488,172509,-17695,0.433559988,0.536134347,-0.102574359
North Carolina,37069,Franklin County,16320,12811,29902,3509,0.545782891,0.428432881,0.11735001
North Carolina,37071,Gaston County,61467,30982,94872,30485,0.647894005,0.326566321,0.321327684
North Carolina,37073,Gates County,2851,2371,5328,480,0.535097598,0.445007508,0.09009009
North Carolina,37075,Graham County,3260,761,4094,2499,0.79628725,0.185881778,0.610405472
North Carolina,37077,Granville County,13500,12827,26920,673,0.501485884,0.476485884,0.025
North Carolina,37079,Greene County,4358,3570,8013,788,0.543866217,0.44552602,0.098340197
North Carolina,37081,Guilford County,97461,147949,252087,-50488,0.386616525,0.586896587,-0.200280062
North Carolina,37083,Halifax County,8954,15642,24881,-6688,0.359872995,0.628672481,-0.268799486
North Carolina,37085,Harnett County,27278,16452,44955,10826,0.606784562,0.365965966,0.240818596
North Carolina,37087,Haywood County,18844,10414,30156,8430,0.624883937,0.345337578,0.279546359
North Carolina,37089,Henderson County,35535,19664,56810,15871,0.625506073,0.346136244,0.279369829
North Carolina,37091,Hertford County,3081,6886,10100,-3805,0.305049505,0.681782178,-0.376732673
North Carolina,37093,Hoke County,7676,9608,17847,-1932,0.430100297,0.538353785,-0.108253488
North Carolina,37095,Hyde County,1275,956,2273,319,0.560932688,0.420589529,0.140343159
North Carolina,37097,Iredell County,54164,24441,80727,29723,0.670952717,0.302761158,0.368191559
North Carolina,37099,Jackson County,9706,7564,18004,2142,0.539102422,0.42012886,0.118973562
North Carolina,37101,Johnston County,54082,28153,84553,25929,0.639622485,0.332962757,0.306659728
North Carolina,37103,Jones County,2941,2041,5039,900,0.583647549,0.405040683,0.178606866
North Carolina,37105,Lee County,13625,10380,24676,3245,0.552155941,0.420651645,0.131504296
North Carolina,37107,Lenoir County,13354,11752,25500,1602,0.523686275,0.460862745,0.06282353
North Carolina,37109,Lincoln County,28653,9836,39449,18817,0.726330198,0.249334584,0.476995614
North Carolina,37113,Macon County,12035,4841,17336,7194,0.69422012,0.279245501,0.414974619
North Carolina,37115,Madison County,6735,3899,10966,2836,0.614171074,0.355553529,0.258617545
North Carolina,37117,Martin County,5874,5814,11852,60,0.495612555,0.490550118,0.005062437
North Carolina,37111,McDowell County,14517,4645,19557,9872,0.742291763,0.237510866,0.504780897
North Carolina,37119,Mecklenburg County,154303,292258,461834,-137955,0.334109225,0.632820451,-0.298711226
North Carolina,37121,Mitchell County,6225,1585,7948,4640,0.783215903,0.199421238,0.583794665
North Carolina,37123,Montgomery County,7070,4108,11449,2962,0.617521181,0.35880863,0.258712551
North Carolina,37125,Moore County,30273,16148,47746,14125,0.634042642,0.338206342,0.2958363
North Carolina,37127,Nash County,23142,23024,46903,118,0.493401275,0.490885444,0.002515831
North Carolina,37129,New Hanover County,54665,50219,108737,4446,0.502726763,0.461839116,0.040887647
North Carolina,37131,Northampton County,3556,6113,9761,-2557,0.364306936,0.6262678,-0.261960864
North Carolina,37133,Onslow County,36342,17156,55364,19186,0.656419334,0.309876454,0.34654288
North Carolina,37135,Orange County,18373,59105,79830,-40732,0.230151572,0.74038582,-0.510234248
North Carolina,37137,Pamlico County,4225,2427,6772,1798,0.623892499,0.358387478,0.265505021
North Carolina,37139,Pasquotank County,8082,8455,16964,-373,0.476420656,0.498408394,-0.021987738
North Carolina,37141,Pender County,17317,9086,27072,8231,0.639664598,0.335623522,0.304041076
North Carolina,37143,Perquimans County,4143,2291,6595,1852,0.628203184,0.347384382,0.280818802
North Carolina,37145,Person County,11116,7772,19303,3344,0.575869036,0.402631715,0.173237321
North Carolina,37147,Pitt County,35191,40967,78264,-5776,0.449644792,0.523446284,-0.073801492
North Carolina,37149,Polk County,6738,3715,10723,3023,0.628368927,0.346451553,0.281917374
North Carolina,37151,Randolph County,49156,13074,63615,36082,0.772710839,0.205517567,0.567193272
North Carolina,37153,Richmond County,10199,8290,18813,1909,0.542125126,0.44065274,0.101472386
North Carolina,37155,Robeson County,20294,18377,39454,1917,0.514371166,0.465782937,0.048588229
North Carolina,37157,Rockingham County,26463,14057,41374,12406,0.639604583,0.339754435,0.299850148
North Carolina,37159,Rowan County,42388,19208,63078,23180,0.671993405,0.304511874,0.367481531
North Carolina,37161,Rutherford County,21694,7451,29764,14243,0.728867088,0.250335976,0.478531112
North Carolina,37163,Sampson County,14761,10486,25638,4275,0.575746938,0.409002262,0.166744676
North Carolina,37165,Scotland County,6212,7279,13743,-1067,0.452011933,0.529651459,-0.077639526
North Carolina,37167,Stanly County,21788,7008,29451,14780,0.7398051,0.237954569,0.501850531
North Carolina,37169,Stokes County,16976,4645,22182,12331,0.765305202,0.209404021,0.555901181
North Carolina,37171,Surry County,23495,7438,31663,16057,0.742033288,0.234911411,0.507121877
North Carolina,37173,Swain County,3557,2186,5982,1371,0.594617185,0.365429622,0.229187563
North Carolina,37175,Transylvania County,10441,6520,17440,3921,0.598681193,0.373853211,0.224827982
North Carolina,37177,Tyrrell County,968,705,1700,263,0.569411765,0.414705882,0.154705883
North Carolina,37179,Union County,66265,34051,103596,32214,0.639648249,0.328690297,0.310957952
North Carolina,37181,Vance County,7304,12168,19762,-4864,0.369598219,0.615727153,-0.246128934
North Carolina,37183,Wake County,193607,298353,510940,-104746,0.378923161,0.58392962,-0.205006459
North Carolina,37185,Warren County,3302,6668,10123,-3366,0.326187889,0.658698014,-0.332510125
North Carolina,37187,Washington County,2560,3490,6115,-930,0.418642682,0.570727719,-0.152085037
North Carolina,37189,Watauga County,13521,13953,28769,-432,0.469985053,0.485001217,-0.015016164
North Carolina,37191,Wayne County,27360,21520,49824,5840,0.549132948,0.43192036,0.117212588
North Carolina,37193,Wilkes County,23613,6596,30844,17017,0.765562184,0.213850344,0.55171184
North Carolina,37195,Wilson County,17410,19527,37593,-2117,0.463118134,0.519431809,-0.056313675
North Carolina,37197,Yadkin County,13815,3140,17350,10675,0.796253602,0.180979827,0.615273775
North Carolina,37199,Yancey County,6367,3181,9808,3186,0.649163948,0.32432708,0.324836868
North Dakota,38001,Adams County,904,216,1206,688,0.749585406,0.179104478,0.570480928
North Dakota,38003,Barnes County,3156,1597,5253,1559,0.600799543,0.304016752,0.296782791
North Dakota,38005,Benson County,927,842,1940,85,0.477835052,0.434020619,0.043814433
North Dakota,38007,Billings County,492,58,592,434,0.831081081,0.097972973,0.733108108
North Dakota,38009,Bottineau County,2482,734,3437,1748,0.722141402,0.213558336,0.508583066
North Dakota,38011,Bowman County,1445,227,1769,1218,0.816845676,0.128321085,0.688524591
North Dakota,38013,Burke County,879,118,1031,761,0.85257032,0.114451988,0.738118332
North Dakota,38015,Burleigh County,32499,10865,46874,21634,0.693326791,0.231791612,0.461535179
North Dakota,38017,Cass County,39738,31291,78807,8447,0.504244547,0.397058637,0.10718591
North Dakota,38019,Cavalier County,1356,476,1969,880,0.688674454,0.24174708,0.446927374
North Dakota,38021,Dickey County,1656,551,2372,1105,0.698145025,0.232293423,0.465851602
North Dakota,38023,Divide County,860,243,1187,617,0.724515586,0.204717776,0.51979781
North Dakota,38025,Dunn County,1753,356,2199,1397,0.797180537,0.161891769,0.635288768
North Dakota,38027,Eddy County,790,354,1219,436,0.64807219,0.290401969,0.357670221
North Dakota,38029,Emmons County,1672,215,1959,1457,0.853496682,0.109749872,0.74374681
North Dakota,38031,Foster County,1237,346,1699,891,0.728075338,0.203649205,0.524426133
North Dakota,38033,Golden Valley County,793,99,942,694,0.841825902,0.105095541,0.736730361
North Dakota,38035,Grand Forks County,16325,10828,29711,5497,0.549459796,0.364444145,0.185015651
North Dakota,38037,Grant County,1098,187,1361,911,0.806759735,0.137398971,0.669360764
North Dakota,38039,Griggs County,847,298,1247,549,0.679230152,0.238973536,0.440256616
North Dakota,38041,Hettinger County,1032,168,1261,864,0.818398097,0.133227597,0.6851705
North Dakota,38043,Kidder County,1106,179,1358,927,0.81443299,0.131811487,0.682621503
North Dakota,38045,LaMoure County,1475,500,2115,975,0.697399527,0.236406619,0.460992908
North Dakota,38047,Logan County,867,112,1030,755,0.841747573,0.108737864,0.733009709
North Dakota,38049,McHenry County,1991,474,2687,1517,0.740975065,0.176404913,0.564570152
North Dakota,38051,McIntosh County,1095,233,1423,862,0.769501054,0.16373858,0.605762474
North Dakota,38053,McKenzie County,3661,696,4594,2965,0.796909012,0.151501959,0.645407053
North Dakota,38055,McLean County,3827,1070,5206,2757,0.735113331,0.205532078,0.529581253
North Dakota,38057,Mercer County,3715,616,4564,3099,0.813978966,0.134969325,0.679009641
North Dakota,38059,Morton County,11319,3077,15547,8242,0.728050428,0.197915997,0.530134431
North Dakota,38061,Mountrail County,2551,1211,4009,1340,0.636318284,0.302070342,0.334247942
North Dakota,38063,Nelson County,1025,536,1694,489,0.605076741,0.316410862,0.288665879
North Dakota,38065,Oliver County,827,119,1002,708,0.825349301,0.118762475,0.706586826
North Dakota,38067,Pembina County,2204,681,3093,1523,0.712576786,0.220174588,0.492402198
North Dakota,38069,Pierce County,1433,431,2020,1002,0.709405941,0.213366337,0.496039604
North Dakota,38071,Ramsey County,3216,1505,5218,1711,0.616328095,0.288424684,0.327903411
North Dakota,38073,Ransom County,1209,836,2317,373,0.521795425,0.360811394,0.160984031
North Dakota,38075,Renville County,978,200,1255,778,0.779282869,0.15936255,0.619920319
North Dakota,38077,Richland County,4759,2064,7460,2695,0.637935657,0.276675603,0.361260054
North Dakota,38079,Rolette County,1210,2097,3662,-887,0.330420535,0.572637903,-0.242217368
North Dakota,38081,Sargent County,1088,693,1978,395,0.550050556,0.350353893,0.199696663
North Dakota,38083,Sheridan County,644,94,774,550,0.832041344,0.121447028,0.710594316
North Dakota,38085,Sioux County,256,758,1177,-502,0.217502124,0.644010195,-0.426508071
North Dakota,38087,Slope County,361,42,427,319,0.845433255,0.098360656,0.747072599
North Dakota,38089,Stark County,9718,1745,12115,7973,0.8021461,0.144036319,0.658109781
North Dakota,38091,Steele County,537,361,984,176,0.545731707,0.366869919,0.178861788
North Dakota,38093,Stutsman County,6706,2484,9938,4222,0.674783659,0.249949688,0.424833971
North Dakota,38095,Towner County,733,305,1137,428,0.64467898,0.26824978,0.3764292
North Dakota,38097,Traill County,2263,1239,3864,1024,0.585662526,0.320652174,0.265010352
North Dakota,38099,Walsh County,2991,1166,4543,1825,0.658375523,0.256658596,0.401716927
North Dakota,38101,Ward County,18601,5792,26861,12809,0.692490972,0.215628607,0.476862365
North Dakota,38103,Wells County,1793,419,2352,1374,0.762329932,0.178146259,0.584183673
North Dakota,38105,Williams County,10033,1722,12529,8311,0.800782185,0.137441137,0.663341048
Nebraska,31001,Adams County,9205,3272,13172,5933,0.698830853,0.248405709,0.450425144
Nebraska,31003,Antelope County,2717,381,3220,2336,0.84378882,0.118322981,0.725465839
Nebraska,31005,Arthur County,237,16,263,221,0.901140684,0.060836502,0.840304182
Nebraska,31007,Banner County,355,18,390,337,0.91025641,0.046153846,0.864102564
Nebraska,31009,Blaine County,273,30,313,243,0.872204473,0.095846645,0.776357828
Nebraska,31011,Boone County,2299,414,2867,1885,0.801883502,0.144401814,0.657481688
Nebraska,31013,Box Butte County,3550,953,4761,2597,0.745641672,0.200168032,0.54547364
Nebraska,31015,Boyd County,978,128,1142,850,0.856392294,0.112084063,0.744308231
Nebraska,31017,Brown County,1380,153,1579,1227,0.873970868,0.09689677,0.777074098
Nebraska,31019,Buffalo County,14424,4690,20477,9734,0.704400059,0.229037457,0.475362602
Nebraska,31021,Burt County,2360,928,3523,1432,0.669883622,0.263411865,0.406471757
Nebraska,31023,Butler County,3068,690,3914,2378,0.783852836,0.17629024,0.607562596
Nebraska,31025,Cass County,8388,3461,12609,4927,0.665239115,0.274486478,0.390752637
Nebraska,31027,Cedar County,3533,572,4360,2961,0.810321101,0.131192661,0.67912844
Nebraska,31029,Chase County,1621,171,1851,1450,0.875742842,0.092382496,0.783360346
Nebraska,31031,Cherry County,2623,317,3082,2306,0.851070733,0.102855289,0.748215444
Nebraska,31033,Cheyenne County,3610,702,4569,2908,0.790107244,0.153644123,0.636463121
Nebraska,31035,Clay County,2373,470,2973,1903,0.798183653,0.158089472,0.640094181
Nebraska,31037,Colfax County,2171,857,3172,1314,0.68442623,0.270176545,0.414249685
Nebraska,31039,Cuming County,3095,712,3988,2383,0.776078235,0.178535607,0.597542628
Nebraska,31041,Custer County,4616,635,5489,3981,0.840954637,0.115685917,0.72526872
Nebraska,31043,Dakota County,4028,2904,7259,1124,0.554897369,0.400055104,0.154842265
Nebraska,31045,Dawes County,2559,785,3578,1774,0.715204025,0.219396311,0.495807714
Nebraska,31047,Dawson County,5935,2116,8486,3819,0.699387226,0.249351874,0.450035352
Nebraska,31049,Deuel County,809,120,977,689,0.828045036,0.122824974,0.705220062
Nebraska,31051,Dixon County,2041,556,2744,1485,0.743804665,0.202623907,0.541180758
Nebraska,31053,Dodge County,9736,4451,14959,5285,0.650845645,0.297546627,0.353299018
Nebraska,31055,Douglas County,102151,105207,219531,-3056,0.465314694,0.479235279,-0.013920585
Nebraska,31057,Dundy County,823,89,949,734,0.867228662,0.093782929,0.773445733
Nebraska,31059,Fillmore County,2100,610,2879,1490,0.729419937,0.211879125,0.517540812
Nebraska,31061,Franklin County,1345,250,1656,1095,0.812198068,0.150966184,0.661231884
Nebraska,31063,Frontier County,1106,161,1310,945,0.844274809,0.122900763,0.721374046
Nebraska,31065,Furnas County,1915,304,2315,1611,0.827213823,0.131317495,0.695896328
Nebraska,31067,Gage County,6333,2930,9854,3403,0.642683174,0.297341181,0.345341993
Nebraska,31069,Garden County,869,153,1063,716,0.817497648,0.143932267,0.673565381
Nebraska,31071,Garfield County,819,121,968,698,0.84607438,0.125,0.72107438
Nebraska,31073,Gosper County,792,165,1000,627,0.792,0.165,0.627
Nebraska,31075,Grant County,367,20,394,347,0.931472081,0.050761421,0.88071066
Nebraska,31077,Greeley County,911,210,1165,701,0.781974249,0.180257511,0.601716738
Nebraska,31079,Hall County,14139,6142,21331,7997,0.662838123,0.287937743,0.37490038
Nebraska,31081,Hamilton County,3763,873,4902,2890,0.767645859,0.178090575,0.589555284
Nebraska,31083,Harlan County,1302,219,1582,1083,0.82300885,0.138432364,0.684576486
Nebraska,31085,Hayes County,471,30,510,441,0.923529412,0.058823529,0.864705883
Nebraska,31087,Hitchcock County,1216,158,1440,1058,0.844444444,0.109722222,0.734722222
Nebraska,31089,Holt County,4275,522,4979,3753,0.858606146,0.104840329,0.753765817
Nebraska,31091,Hooker County,355,40,414,315,0.857487923,0.096618357,0.760869566
Nebraska,31093,Howard County,2284,544,2958,1740,0.77214334,0.183908046,0.588235294
Nebraska,31095,Jefferson County,2387,831,3430,1556,0.695918367,0.242274052,0.453644315
Nebraska,31097,Johnson County,1348,560,2051,788,0.657240371,0.273037543,0.384202828
Nebraska,31099,Kearney County,2519,550,3242,1969,0.776989513,0.169648365,0.607341148
Nebraska,31101,Keith County,3203,560,3945,2643,0.811913815,0.141951838,0.669961977
Nebraska,31103,Keya Paha County,458,39,514,419,0.891050584,0.075875486,0.815175098
Nebraska,31105,Kimball County,1317,227,1636,1090,0.805012225,0.138753056,0.666259169
Nebraska,31107,Knox County,3181,715,4061,2466,0.783304605,0.176065009,0.607239596
Nebraska,31109,Lancaster County,60456,60533,129803,-77,0.465751947,0.466345154,-0.000593207
Nebraska,31111,Lincoln County,11992,2878,15674,9114,0.765088682,0.18361618,0.581472502
Nebraska,31113,Logan County,400,32,451,368,0.88691796,0.070953437,0.815964523
Nebraska,31115,Loup County,323,48,382,275,0.845549738,0.12565445,0.719895288
Nebraska,31119,Madison County,10518,2663,13956,7855,0.753654342,0.190813987,0.562840355
Nebraska,31117,McPherson County,257,14,286,243,0.898601399,0.048951049,0.84965035
Nebraska,31121,Merrick County,2914,601,3707,2313,0.786080388,0.162125708,0.62395468
Nebraska,31123,Morrill County,1788,282,2166,1506,0.825484765,0.130193906,0.695290859
Nebraska,31125,Nance County,1257,280,1599,977,0.786116323,0.175109443,0.61100688
Nebraska,31127,Nemaha County,2068,765,3035,1303,0.681383855,0.252059308,0.429324547
Nebraska,31129,Nuckolls County,1709,348,2153,1361,0.793776126,0.161634928,0.632141198
Nebraska,31131,Otoe County,4833,2017,7279,2816,0.66396483,0.277098503,0.386866327
Nebraska,31133,Pawnee County,970,279,1314,691,0.738203957,0.212328767,0.52587519
Nebraska,31135,Perkins County,1202,160,1418,1042,0.847672779,0.112834979,0.7348378
Nebraska,31137,Phelps County,3832,571,4609,3261,0.831416793,0.123888045,0.707528748
Nebraska,31139,Pierce County,3052,382,3580,2670,0.852513966,0.106703911,0.745810055
Nebraska,31141,Platte County,10864,2612,14047,8252,0.773403574,0.185947177,0.587456397
Nebraska,31143,Polk County,2019,411,2538,1608,0.795508274,0.161938534,0.63356974
Nebraska,31145,Red Willow County,4212,638,5061,3574,0.832246592,0.126062043,0.706184549
Nebraska,31147,Richardson County,2684,798,3666,1886,0.732133115,0.217675941,0.514457174
Nebraska,31149,Rock County,687,70,793,617,0.866330391,0.088272383,0.778058008
Nebraska,31151,Saline County,2849,1630,4795,1219,0.594160584,0.339937435,0.254223149
Nebraska,31153,Sarpy County,44649,27704,77781,16945,0.57403479,0.35617953,0.21785526
Nebraska,31155,Saunders County,7486,2509,10598,4977,0.706359691,0.236742782,0.469616909
Nebraska,31157,Scotts Bluff County,9952,3151,13895,6801,0.716228859,0.22677222,0.489456639
Nebraska,31159,Seward County,5451,1881,7754,3570,0.702992004,0.242584473,0.460407531
Nebraska,31161,Sheridan County,2192,286,2565,1906,0.854580897,0.111500975,0.743079922
Nebraska,31163,Sherman County,1143,338,1553,805,0.735994849,0.217643271,0.518351578
Nebraska,31165,Sioux County,602,77,709,525,0.849083216,0.108603667,0.740479549
Nebraska,31167,Stanton County,2173,417,2748,1756,0.790756914,0.151746725,0.639010189
Nebraska,31169,Thayer County,1993,490,2613,1503,0.762724837,0.187523919,0.575200918
Nebraska,31171,Thomas County,344,30,387,314,0.888888889,0.07751938,0.811369509
Nebraska,31173,Thurston County,1013,911,2029,102,0.49926072,0.44898965,0.05027107
Nebraska,31175,Valley County,1770,337,2172,1433,0.814917127,0.155156538,0.659760589
Nebraska,31177,Washington County,7374,2606,10584,4768,0.696712018,0.246220711,0.450491307
Nebraska,31179,Wayne County,2675,828,3740,1847,0.715240642,0.221390374,0.493850268
Nebraska,31181,Webster County,1320,306,1687,1014,0.78245406,0.181387078,0.601066982
Nebraska,31183,Wheeler County,377,62,459,315,0.821350763,0.135076253,0.68627451
Nebraska,31185,York County,4686,1181,6256,3505,0.749040921,0.188778772,0.560262149
New Hampshire,33001,Belknap County,19315,13517,34462,5798,0.560472404,0.392229122,0.168243282
New Hampshire,33003,Carroll County,14635,12987,29063,1648,0.503561229,0.446856828,0.056704401
New Hampshire,33005,Cheshire County,16876,22064,41080,-5188,0.410808179,0.537098345,-0.126290166
New Hampshire,33007,Coos County,7951,6558,15255,1393,0.521206162,0.429891839,0.091314323
New Hampshire,33009,Grafton County,19010,28510,50065,-9500,0.379706382,0.569459702,-0.18975332
New Hampshire,33011,Hillsborough County,100013,99589,210622,424,0.474845933,0.472832847,0.002013086
New Hampshire,33013,Merrimack County,37674,40198,81982,-2524,0.459539899,0.490327145,-0.030787246
New Hampshire,33015,Rockingham County,90447,79994,179005,10453,0.505276389,0.446881372,0.058395017
New Hampshire,33017,Strafford County,29072,34894,67918,-5822,0.428045584,0.513766601,-0.085721017
New Hampshire,33019,Sullivan County,10796,10210,22101,586,0.488484684,0.461970047,0.026514637
New Jersey,34001,Atlantic County,47882,54472,105738,-6590,0.452836256,0.515160113,-0.062323857
New Jersey,34003,Bergen County,163220,209251,383965,-46031,0.425090829,0.544974151,-0.119883322
New Jersey,34005,Burlington County,79539,108361,194988,-28822,0.40791741,0.555731635,-0.147814225
New Jersey,34007,Camden County,71020,142375,220437,-71355,0.322178219,0.645876146,-0.323697927
New Jersey,34009,Cape May County,28237,18626,48375,9611,0.583710594,0.385033592,0.198677002
New Jersey,34011,Cumberland County,24213,27045,53018,-2832,0.456693953,0.510109774,-0.053415821
New Jersey,34013,Essex County,62059,231031,299808,-168972,0.206995811,0.770596515,-0.563600704
New Jersey,34015,Gloucester County,66949,66355,138388,594,0.483777495,0.479485215,0.00429228
New Jersey,34017,Hudson County,45615,149980,201425,-104365,0.226461462,0.744594762,-0.5181333
New Jersey,34019,Hunterdon County,38565,28797,70582,9768,0.546385764,0.407993539,0.138392225
New Jersey,34021,Mercer County,42604,93721,141332,-51117,0.30144624,0.663126539,-0.361680299
New Jersey,34023,Middlesex County,108981,164887,282668,-55906,0.385544172,0.583323899,-0.197779727
New Jersey,34025,Monmouth County,165305,135825,311474,29480,0.530718455,0.436071711,0.094646744
New Jersey,34027,Morris County,125376,114437,248848,10939,0.503825628,0.459867067,0.043958561
New Jersey,34029,Ocean County,170103,81845,259592,88258,0.655270578,0.315283214,0.339987364
New Jersey,34031,Passaic County,71488,112608,189099,-41120,0.378045362,0.595497596,-0.217452234
New Jersey,34033,Salem County,16256,11766,29220,4490,0.55633128,0.402669405,0.153661875
New Jersey,34035,Somerset County,64640,83839,154249,-19199,0.419062684,0.543530266,-0.124467582
New Jersey,34037,Sussex County,46486,24132,73860,22354,0.629379908,0.326726239,0.302653669
New Jersey,34039,Union County,67582,145412,219385,-77830,0.308052055,0.66281651,-0.354764455
New Jersey,34041,Warren County,29393,16991,48442,12402,0.606766855,0.35074935,0.256017505
New Mexico,35001,Bernalillo County,93874,141960,269861,-48086,0.347860565,0.526048595,-0.17818803
New Mexico,35003,Catron County,1453,426,2024,1027,0.717885375,0.210474308,0.507411067
New Mexico,35005,Chaves County,12869,5530,20159,7339,0.638374919,0.274319163,0.364055756
New Mexico,35006,Cibola County,3179,3721,7975,-542,0.39862069,0.466583072,-0.067962382
New Mexico,35007,Colfax County,2569,2118,5271,451,0.487383798,0.401821286,0.085562512
New Mexico,35009,Curry County,7560,2776,11292,4784,0.669500531,0.245837761,0.42366277
New Mexico,35011,De Baca County,617,192,903,425,0.683277962,0.212624585,0.470653377
New Mexico,35013,Dona Ana County,25095,37543,69324,-12448,0.361995846,0.541558479,-0.179562633
New Mexico,35015,Eddy County,13124,5008,19523,8116,0.672232751,0.256517953,0.415714798
New Mexico,35017,Grant County,5251,6226,12633,-975,0.415657405,0.492836223,-0.077178818
New Mexico,35019,Guadalupe County,591,962,1809,-371,0.326699834,0.531785517,-0.205085683
New Mexico,35021,Harding County,311,156,527,155,0.590132827,0.29601518,0.294117647
New Mexico,35023,Hidalgo County,906,780,1836,126,0.493464052,0.424836601,0.068627451
New Mexico,35025,Lea County,12306,3877,17369,8429,0.708503656,0.223213772,0.485289884
New Mexico,35027,Lincoln County,5889,2329,8856,3560,0.6649729,0.262985547,0.401987353
New Mexico,35028,Los Alamos County,3329,5443,10430,-2114,0.319175455,0.521860019,-0.202684564
New Mexico,35029,Luna County,3478,3195,7245,283,0.48005521,0.440993789,0.039061421
New Mexico,35031,McKinley County,4893,13162,20791,-8269,0.235342215,0.633062383,-0.397720168
New Mexico,35033,Mora County,662,1533,2429,-871,0.27254014,0.631123919,-0.358583779
New Mexico,35035,Otero County,11756,6033,19636,5723,0.598696272,0.307241801,0.291454471
New Mexico,35037,Quay County,2208,1016,3550,1192,0.621971831,0.286197183,0.335774648
New Mexico,35039,Rio Arriba County,3583,9534,14767,-5951,0.242635606,0.645628767,-0.402993161
New Mexico,35041,Roosevelt County,3865,1445,5855,2420,0.660119556,0.246797609,0.413321947
New Mexico,35043,Sandoval County,25748,27405,60597,-1657,0.424905523,0.452250111,-0.027344588
New Mexico,35045,San Juan County,27879,12826,45476,15053,0.613048641,0.282038878,0.331009763
New Mexico,35047,San Miguel County,2302,7249,10662,-4947,0.215906959,0.679891202,-0.463984243
New Mexico,35049,Santa Fe County,14198,49956,70082,-35758,0.20259125,0.712822123,-0.510230873
New Mexico,35051,Sierra County,2998,1600,5129,1398,0.584519399,0.311951647,0.272567752
New Mexico,35053,Socorro County,2592,3275,6756,-683,0.38365897,0.484754292,-0.101095322
New Mexico,35055,Taos County,2706,10550,15072,-7844,0.179538217,0.699973461,-0.520435244
New Mexico,35057,Torrance County,3695,1770,6250,1925,0.5912,0.2832,0.308
New Mexico,35059,Union County,1214,318,1688,896,0.719194313,0.188388626,0.530805687
New Mexico,35061,Valencia County,13175,10810,27350,2365,0.481718464,0.395246801,0.086471663
Nevada,32510,Carson City,13125,9610,25016,3515,0.524664215,0.384154141,0.140510074
Nevada,32001,Churchill County,7828,2210,10936,5618,0.715801024,0.202084857,0.513716167
Nevada,32003,Clark County,319571,401068,765421,-81497,0.417510102,0.523983533,-0.106473431
Nevada,32005,Douglas County,17406,8453,27871,8953,0.624520111,0.303290158,0.321229953
Nevada,32007,Elko County,13542,3400,18545,10142,0.73022378,0.183337827,0.546885953
Nevada,32009,Esmeralda County,329,65,423,264,0.777777778,0.153664303,0.624113475
Nevada,32011,Eureka County,723,74,854,649,0.846604215,0.086651054,0.759953161
Nevada,32013,Humboldt County,4521,1386,6433,3135,0.702782528,0.215451578,0.48733095
Nevada,32015,Lander County,1828,403,2413,1425,0.757563199,0.167012018,0.590551181
Nevada,32017,Lincoln County,1671,285,2132,1386,0.783771107,0.133677298,0.650093809
Nevada,32019,Lyon County,16005,6146,23762,9859,0.673554415,0.258648262,0.414906153
Nevada,32021,Mineral County,1179,637,1997,542,0.590385578,0.318978468,0.27140711
Nevada,32023,Nye County,13320,5095,19592,8225,0.679869334,0.260055125,0.419814209
Nevada,32027,Pershing County,1403,430,1982,973,0.707870838,0.216952573,0.490918265
Nevada,32029,Storey County,1616,752,2558,864,0.63174355,0.293979672,0.337763878
Nevada,32031,Washoe County,94529,97032,209282,-2503,0.451682419,0.463642358,-0.011959939
Nevada,32033,White Pine County,2723,707,3773,2016,0.721706865,0.187384045,0.53432282
New York,36001,Albany County,44227,74775,125644,-30548,0.352002483,0.59513387,-0.243131387
New York,36003,Allegany County,11712,4473,17111,7239,0.684471977,0.261410788,0.423061189
New York,36005,Bronx County,34424,318403,358857,-283979,0.09592679,0.88726986,-0.79134307
New York,36007,Broome County,38077,35212,77657,2865,0.49032283,0.453429826,0.036893004
New York,36009,Cattaraugus County,18668,8717,28961,9951,0.644591002,0.300990988,0.343600014
New York,36011,Cayuga County,16194,12202,30124,3992,0.537578011,0.405059089,0.132518922
New York,36013,Chautauqua County,29418,17281,49381,12137,0.595735202,0.349952411,0.245782791
New York,36015,Chemung County,19025,12394,33195,6631,0.573128483,0.373369483,0.199759
New York,36017,Chenango County,11024,5943,18113,5081,0.60862364,0.328106885,0.280516755
New York,36019,Clinton County,13181,13446,28378,-265,0.464479526,0.473817746,-0.00933822
New York,36021,Columbia County,12756,13123,27255,-367,0.468024216,0.481489635,-0.013465419
New York,36023,Cortland County,9207,7976,18424,1231,0.499728615,0.432913591,0.066815024
New York,36025,Delaware County,11012,5825,17778,5187,0.619417257,0.327652154,0.291765103
New York,36027,Dutchess County,58163,56874,120199,1289,0.483889217,0.473165334,0.010723883
New York,36029,Erie County,173817,192065,383248,-18248,0.453536613,0.501150691,-0.047614078
New York,36031,Essex County,7275,6760,15079,515,0.482459049,0.448305591,0.034153458
New York,36033,Franklin County,7636,6517,15148,1119,0.50409295,0.430221811,0.073871139
New York,36035,Fulton County,12759,5805,19563,6954,0.652200583,0.29673363,0.355466953
New York,36037,Genesee County,15986,6946,24463,9040,0.653476679,0.28393901,0.369537669
New York,36039,Greene County,11546,6370,18869,5176,0.611903122,0.337590757,0.274312365
New York,36041,Hamilton County,1795,752,2688,1043,0.667782738,0.279761905,0.388020833
New York,36043,Herkimer County,15664,7289,24261,8375,0.645645274,0.300441037,0.345204237
New York,36045,Jefferson County,19947,12289,34263,7658,0.58217319,0.358666783,0.223506407
New York,36047,Kings County,133653,595086,746295,-461433,0.179088698,0.797387092,-0.618298394
New York,36049,Lewis County,6916,2828,10312,4088,0.670674942,0.2742436,0.396431342
New York,36051,Livingston County,19211,10478,31363,8733,0.612537066,0.334087938,0.278449128
New York,36053,Madison County,14901,10548,27392,4353,0.543990946,0.385075935,0.158915011
New York,36055,Monroe County,128871,174063,320164,-45192,0.402515586,0.543668245,-0.141152659
New York,36057,Montgomery County,10579,5961,17438,4618,0.606663608,0.341839661,0.264823947
New York,36059,Nassau County,275479,307326,599649,-31847,0.459400416,0.512509818,-0.053109402
New York,36061,New York County,58935,515481,591368,-456546,0.099658757,0.871675505,-0.772016748
New York,36063,Niagara County,49223,32888,86000,16335,0.572360465,0.382418605,0.18994186
New York,36065,Oneida County,48490,30749,83876,17741,0.578115313,0.366600696,0.211514617
New York,36067,Onondaga County,78277,102915,191962,-24638,0.407773413,0.536121732,-0.128348319
New York,36069,Ontario County,24343,20233,47664,4110,0.510720879,0.424492279,0.0862286
New York,36071,Orange County,72129,63037,140753,9092,0.512450889,0.447855463,0.064595426
New York,36073,Orleans County,11582,4327,16722,7255,0.6926205,0.258760914,0.433859586
New York,36075,Oswego County,25870,15614,44122,10256,0.586328816,0.353882417,0.232446399
New York,36077,Otsego County,12284,9285,23024,2999,0.533530229,0.403274844,0.130255385
New York,36079,Putnam County,25241,17363,44186,7878,0.571244286,0.392952519,0.178291767
New York,36081,Queens County,138550,473389,627021,-334839,0.220965486,0.754981093,-0.534015607
New York,36083,Rensselaer County,31933,30039,65991,1894,0.48389932,0.455198436,0.028700884
New York,36085,Richmond County,95612,67561,167209,28051,0.571811326,0.404051217,0.167760109
New York,36087,Rockland County,57148,63454,123943,-6306,0.461082917,0.511961143,-0.050878226
New York,36091,Saratoga County,51088,46546,104089,4542,0.490810748,0.447175014,0.043635734
New York,36093,Schenectady County,27268,30870,61629,-3602,0.442454039,0.50090055,-0.058446511
New York,36095,Schoharie County,8173,3777,12673,4396,0.644914385,0.298035193,0.346879192
New York,36097,Schuyler County,5179,2761,8423,2418,0.614864063,0.327792948,0.287071115
New York,36099,Seneca County,6719,5175,12727,1544,0.527932741,0.406615856,0.121316885
New York,36089,St. Lawrence County,18450,14659,35154,3791,0.524833589,0.416993799,0.10783979
New York,36101,Steuben County,25091,11215,38373,13876,0.653871212,0.292262789,0.361608423
New York,36103,Suffolk County,328403,276953,625720,51450,0.524840184,0.442614908,0.082225276
New York,36105,Sullivan County,14626,10983,26509,3643,0.551737146,0.41431212,0.137425026
New York,36107,Tioga County,12528,6852,20556,5676,0.609457093,0.333333333,0.27612376
New York,36109,Tompkins County,9647,25555,37747,-15908,0.255569979,0.677007444,-0.421437465
New York,36111,Ulster County,32962,40010,77134,-7048,0.427334249,0.518707703,-0.091373454
New York,36113,Warren County,14284,11366,27568,2918,0.51813697,0.412289611,0.105847359
New York,36115,Washington County,12770,8238,22401,4532,0.570063836,0.36775144,0.202312396
New York,36117,Wayne County,21935,12378,36598,9557,0.599349691,0.338215203,0.261134488
New York,36119,Westchester County,121643,245670,378506,-124027,0.321376676,0.649051798,-0.327675122
New York,36121,Wyoming County,11884,3585,16280,8299,0.72997543,0.220208845,0.509766585
New York,36123,Yates County,5180,3219,8975,1961,0.577158774,0.358662953,0.218495821
Ohio,39001,Adams County,8445,2293,11063,6152,0.763355329,0.207267468,0.556087861
Ohio,39003,Allen County,29858,12815,44636,17043,0.668921946,0.287100099,0.381821847
Ohio,39005,Ashland County,17169,5659,24074,11510,0.713176041,0.235066877,0.478109164
Ohio,39007,Ashtabula County,22755,15191,39809,7564,0.571604411,0.381597126,0.190007285
Ohio,39009,Athens County,10816,15552,27941,-4736,0.387101392,0.55660141,-0.169500018
Ohio,39011,Auglaize County,18130,3825,22860,14305,0.793088364,0.167322835,0.625765529
Ohio,39013,Belmont County,20729,8652,30537,12077,0.678815863,0.283328421,0.395487442
Ohio,39015,Brown County,14257,4270,19139,9987,0.744918752,0.223104655,0.521814097
Ohio,39017,Butler County,104441,56700,168422,47741,0.620114949,0.336654356,0.283460593
Ohio,39019,Carroll County,9067,3124,12807,5943,0.707972203,0.243929101,0.464043102
Ohio,39021,Champaign County,12314,4488,17597,7826,0.699778371,0.255043473,0.444734898
Ohio,39023,Clark County,34311,22666,59620,11645,0.5754948,0.380174438,0.195320362
Ohio,39025,Clermont County,65960,26096,96455,39864,0.683842206,0.270551034,0.413291172
Ohio,39027,Clinton County,13466,3943,18100,9523,0.743977901,0.217845304,0.526132597
Ohio,39029,Columbiana County,31086,12273,45261,18813,0.686816465,0.271160602,0.415655863
Ohio,39031,Coshocton County,10381,3908,14961,6473,0.693870731,0.261212486,0.432658245
Ohio,39033,Crawford County,13265,4518,18702,8747,0.70928243,0.241578441,0.467703989
Ohio,39035,Cuyahoga County,179894,383974,583230,-204080,0.308444353,0.658357766,-0.349913413
Ohio,39037,Darke County,19698,4395,25000,15303,0.78792,0.1758,0.61212
Ohio,39039,Defiance County,11478,5282,17795,6196,0.645012644,0.296824951,0.348187693
Ohio,39041,Delaware County,55660,39584,100101,16076,0.556038401,0.395440605,0.160597796
Ohio,39043,Erie County,19301,15692,36730,3609,0.525483256,0.427225701,0.098257555
Ohio,39045,Fairfield County,43163,24150,70542,19013,0.611876613,0.342349239,0.269527374
Ohio,39047,Fayette County,7763,2672,10817,5091,0.717666636,0.247018582,0.470648054
Ohio,39049,Franklin County,192328,335961,554711,-143633,0.34671748,0.60565051,-0.25893303
Ohio,39051,Fulton County,13419,5981,20693,7438,0.648480162,0.289034939,0.359445223
Ohio,39053,Gallia County,9567,2564,12588,7003,0.760009533,0.20368605,0.556323483
Ohio,39055,Geauga County,29577,17165,48736,12412,0.606881976,0.35220371,0.254678266
Ohio,39057,Greene County,47506,28023,79633,19483,0.596561727,0.35190185,0.244659877
Ohio,39059,Guernsey County,11164,4286,16156,6878,0.691012627,0.265288438,0.425724189
Ohio,39061,Hamilton County,169972,207587,395000,-37615,0.430308861,0.525536709,-0.095227848
Ohio,39063,Hancock County,23777,9419,35216,14358,0.675176056,0.267463653,0.407712403
Ohio,39065,Hardin County,8541,2870,12014,5671,0.710920593,0.238887964,0.472032629
Ohio,39067,Harrison County,5021,1663,6956,3358,0.721822887,0.239074181,0.482748706
Ohio,39069,Henry County,9136,3690,13671,5446,0.668275913,0.269914417,0.398361496
Ohio,39071,Highland County,13005,3436,17048,9569,0.762846082,0.201548569,0.561297513
Ohio,39073,Hocking County,8282,3713,12513,4569,0.661871653,0.296731399,0.365140254
Ohio,39075,Holmes County,8578,1766,10823,6812,0.792571376,0.163171025,0.629400351
Ohio,39077,Huron County,15930,7080,24332,8850,0.654693408,0.290974848,0.36371856
Ohio,39079,Jackson County,9618,3142,13239,6476,0.726489916,0.237329103,0.489160813
Ohio,39081,Jefferson County,20668,9483,31346,11185,0.659350475,0.302526638,0.356823837
Ohio,39083,Knox County,18563,7959,27768,10604,0.668503313,0.286624892,0.381878421
Ohio,39085,Lake County,62627,45056,112790,17571,0.555253125,0.399468038,0.155785087
Ohio,39087,Lawrence County,18240,6849,25949,11391,0.702917261,0.263940807,0.438976454
Ohio,39089,Licking County,49346,26360,79399,22986,0.621493973,0.331994106,0.289499867
Ohio,39091,Logan County,15586,4537,21007,11049,0.741943162,0.215975627,0.525967535
Ohio,39093,Lorain County,65346,64958,136654,388,0.478185783,0.475346496,0.002839287
Ohio,39095,Lucas County,74102,107363,191684,-33261,0.38658417,0.56010413,-0.17351996
Ohio,39097,Madison County,11319,4662,16754,6657,0.675599857,0.278261908,0.397337949
Ohio,39099,Mahoning County,52808,56188,112827,-3380,0.468043997,0.498001365,-0.029957368
Ohio,39101,Marion County,16563,7748,25648,8815,0.645781347,0.302089832,0.343691515
Ohio,39103,Medina County,53811,31582,89360,22229,0.602182184,0.353424351,0.248757833
Ohio,39105,Meigs County,6869,2157,9410,4712,0.729968119,0.22922423,0.500743889
Ohio,39107,Mercer County,17200,3335,21315,13865,0.806943467,0.156462585,0.650480882
Ohio,39109,Miami County,36311,12832,51467,23479,0.705520042,0.24932481,0.456195232
Ohio,39111,Monroe County,4781,1647,6686,3134,0.715076279,0.246335627,0.468740652
Ohio,39113,Montgomery County,120766,117661,249560,3105,0.483915692,0.471473794,0.012441898
Ohio,39115,Morgan County,4315,1711,6290,2604,0.686009539,0.272019078,0.413990461
Ohio,39117,Morrow County,11722,3711,16186,8011,0.724206104,0.229272211,0.494933893
Ohio,39119,Muskingum County,23588,10926,36217,12662,0.651296353,0.301681531,0.349614822
Ohio,39121,Noble County,4441,1201,5875,3240,0.755914894,0.204425532,0.551489362
Ohio,39123,Ottawa County,12389,8136,21742,4253,0.569818784,0.374206605,0.195612179
Ohio,39125,Paulding County,6359,2068,8842,4291,0.719181181,0.233883737,0.485297444
Ohio,39127,Perry County,9978,4072,14647,5906,0.681231652,0.278009149,0.403222503
Ohio,39129,Pickaway County,16482,6325,23814,10157,0.692113883,0.265600067,0.426513816
Ohio,39131,Pike County,7669,3443,11513,4226,0.666116564,0.299053244,0.36706332
Ohio,39133,Portage County,38978,31463,73968,7515,0.526957603,0.425359615,0.101597988
Ohio,39135,Preble County,15376,4323,20475,11053,0.750964591,0.211135531,0.53982906
Ohio,39137,Putnam County,14704,2874,18387,11830,0.799695437,0.156306086,0.643389351
Ohio,39139,Richland County,35805,15629,53739,20176,0.666275889,0.290831612,0.375444277
Ohio,39141,Ross County,17833,9905,28955,7928,0.615886721,0.342082542,0.273804179
Ohio,39143,Sandusky County,16045,9733,27491,6312,0.583645557,0.354043141,0.229602416
Ohio,39145,Scioto County,19742,8841,29618,10901,0.666554122,0.298500912,0.36805321
Ohio,39147,Seneca County,14559,7237,23481,7322,0.620033218,0.308206635,0.311826583
Ohio,39149,Shelby County,18148,4143,23110,14005,0.785287754,0.179273042,0.606014712
Ohio,39151,Stark County,96345,66581,170868,29764,0.56385631,0.389663366,0.174192944
Ohio,39153,Summit County,109531,129922,249937,-20391,0.438234435,0.519818994,-0.081584559
Ohio,39155,Trumbull County,48152,42130,94073,6022,0.511857813,0.447843696,0.064014117
Ohio,39157,Tuscarawas County,26105,11895,40088,14210,0.651192377,0.296722211,0.354470166
Ohio,39159,Union County,17601,7530,26533,10071,0.663362605,0.283797535,0.37956507
Ohio,39161,Van Wert County,10328,2667,13584,7661,0.760306243,0.196333922,0.563972321
Ohio,39163,Vinton County,3799,1332,5393,2467,0.704431671,0.246986835,0.457444836
Ohio,39165,Warren County,75947,33036,114254,42911,0.66472071,0.289145238,0.375575472
Ohio,39167,Washington County,19901,7841,28992,12060,0.68643074,0.270453918,0.415976822
Ohio,39169,Wayne County,31622,14670,48550,16952,0.651328527,0.302162719,0.349165808
Ohio,39171,Williams County,11706,4287,16938,7419,0.69110875,0.253099539,0.438009211
Ohio,39173,Wood County,31734,26440,62287,5294,0.509480309,0.424486651,0.084993658
Ohio,39175,Wyandot County,7346,2484,10396,4862,0.70661793,0.238938053,0.467679877
Oklahoma,40001,Adair County,4753,1374,6468,3379,0.734848485,0.212430427,0.522418058
Oklahoma,40003,Alfalfa County,1931,216,2256,1715,0.855939716,0.095744681,0.760195035
Oklahoma,40005,Atoka County,4068,795,5002,3273,0.81327469,0.158936425,0.654338265
Oklahoma,40007,Beaver County,1987,176,2237,1811,0.888243183,0.078676799,0.809566384
Oklahoma,40009,Beckham County,6287,958,7529,5329,0.835037854,0.127241334,0.70779652
Oklahoma,40011,Blaine County,2884,711,3793,2173,0.760348009,0.187450567,0.572897442
Oklahoma,40013,Bryan County,10449,2793,13775,7656,0.758548094,0.202758621,0.555789473
Oklahoma,40015,Caddo County,6473,2418,9336,4055,0.693337618,0.258997429,0.434340189
Oklahoma,40017,Canadian County,39969,11666,55250,28303,0.723420814,0.211149321,0.512271493
Oklahoma,40019,Carter County,13751,4002,18533,9749,0.741973777,0.215939136,0.526034641
Oklahoma,40021,Cherokee County,9992,5455,16487,4537,0.606053254,0.330866743,0.275186511
Oklahoma,40023,Choctaw County,4202,1064,5419,3138,0.775419819,0.196346189,0.57907363
Oklahoma,40025,Cimarron County,962,70,1077,892,0.893221913,0.064995357,0.828226556
Oklahoma,40027,Cleveland County,62469,38790,109326,23679,0.571401131,0.354810384,0.216590747
Oklahoma,40029,Coal County,1892,411,2393,1481,0.790639365,0.17175094,0.618888425
Oklahoma,40031,Comanche County,19153,11439,32504,7714,0.589250554,0.351925917,0.237324637
Oklahoma,40033,Cotton County,2054,424,2602,1630,0.789392775,0.162951576,0.626441199
Oklahoma,40035,Craig County,4279,1249,5778,3030,0.74056767,0.216164763,0.524402907
Oklahoma,40037,Creek County,21539,5834,28786,15705,0.748245675,0.202667964,0.545577711
Oklahoma,40039,Custer County,7818,2102,10531,5716,0.742379641,0.199601177,0.542778464
Oklahoma,40041,Delaware County,11796,3306,15680,8490,0.752295918,0.210841837,0.541454081
Oklahoma,40043,Dewey County,1964,222,2246,1742,0.874443455,0.098842386,0.775601069
Oklahoma,40045,Ellis County,1610,155,1826,1455,0.881708653,0.084884995,0.796823658
Oklahoma,40047,Garfield County,15998,4391,21692,11607,0.737506915,0.202424857,0.535082058
Oklahoma,40049,Garvin County,8243,1852,10531,6391,0.782736682,0.175861742,0.60687494
Oklahoma,40051,Grady County,17293,3878,22257,13415,0.776969043,0.174237319,0.602731724
Oklahoma,40053,Grant County,1827,287,2200,1540,0.830454545,0.130454545,0.7
Oklahoma,40055,Greer County,1482,323,1896,1159,0.78164557,0.17035865,0.61128692
Oklahoma,40057,Harmon County,714,224,975,490,0.732307692,0.22974359,0.502564102
Oklahoma,40059,Harper County,1307,131,1485,1176,0.88013468,0.088215488,0.791919192
Oklahoma,40061,Haskell County,3697,882,4734,2815,0.780946346,0.186311787,0.594634559
Oklahoma,40063,Hughes County,3387,961,4525,2426,0.748508287,0.212375691,0.536132596
Oklahoma,40065,Jackson County,5969,1473,7806,4496,0.764668204,0.188700999,0.575967205
Oklahoma,40067,Jefferson County,1905,365,2345,1540,0.812366738,0.15565032,0.656716418
Oklahoma,40069,Johnston County,3081,782,4001,2299,0.770057486,0.195451137,0.574606349
Oklahoma,40071,Kay County,12168,3734,16795,8434,0.72450134,0.222328074,0.502173266
Oklahoma,40073,Kingfisher County,5151,783,6123,4368,0.841254287,0.127878491,0.713375796
Oklahoma,40075,Kiowa County,2593,766,3489,1827,0.743192892,0.219547148,0.523645744
Oklahoma,40077,Latimer County,3094,797,4050,2297,0.763950617,0.196790123,0.567160494
Oklahoma,40079,Le Flore County,13346,3245,17199,10101,0.775975347,0.18867376,0.587301587
Oklahoma,40081,Lincoln County,10838,2423,14001,8415,0.774087565,0.173059067,0.601028498
Oklahoma,40083,Logan County,13613,4239,18948,9374,0.718439941,0.223717543,0.494722398
Oklahoma,40085,Love County,2920,735,3787,2185,0.771058886,0.194085028,0.576973858
Oklahoma,40093,Major County,2940,310,3399,2630,0.864960282,0.091203295,0.773756987
Oklahoma,40095,Marshall County,4202,1095,5487,3107,0.765810097,0.199562603,0.566247494
Oklahoma,40097,Mayes County,11550,3423,15712,8127,0.735106925,0.217858961,0.517247964
Oklahoma,40087,McClain County,13151,2893,16839,10258,0.780984619,0.171803551,0.609181068
Oklahoma,40089,McCurtain County,8642,1799,10709,6843,0.806984779,0.167989542,0.638995237
Oklahoma,40091,McIntosh County,5501,2122,7958,3379,0.691254084,0.266649912,0.424604172
Oklahoma,40099,Murray County,4173,1086,5525,3087,0.755294118,0.196561086,0.558733032
Oklahoma,40101,Muskogee County,15029,7969,24193,7060,0.621212747,0.3293928,0.291819947
Oklahoma,40103,Noble County,3707,901,4870,2806,0.761190965,0.185010267,0.576180698
Oklahoma,40105,Nowata County,3321,742,4237,2579,0.783809299,0.175123908,0.608685391
Oklahoma,40107,Okfuskee County,2791,943,3933,1848,0.70963641,0.239766082,0.469870328
Oklahoma,40109,Oklahoma County,141429,112661,273609,28768,0.516901856,0.411759116,0.10514274
Oklahoma,40111,Okmulgee County,8926,4379,13924,4547,0.641051422,0.314492962,0.32655846
Oklahoma,40113,Osage County,12559,5593,18942,6966,0.663023968,0.295269771,0.367754197
Oklahoma,40115,Ottawa County,7627,2584,10686,5043,0.713737601,0.241811716,0.471925885
Oklahoma,40117,Pawnee County,4716,1341,6346,3375,0.743145288,0.211314214,0.531831074
Oklahoma,40119,Payne County,16644,8785,27749,7859,0.599805398,0.316587985,0.283217413
Oklahoma,40121,Pittsburg County,12740,3704,17250,9036,0.738550725,0.214724638,0.523826087
Oklahoma,40123,Pontotoc County,10420,3633,14814,6787,0.703388686,0.245240988,0.458147698
Oklahoma,40125,Pottawatomie County,17826,6005,25417,11821,0.701341622,0.236259197,0.465082425
Oklahoma,40127,Pushmataha County,3581,748,4483,2833,0.798795449,0.166852554,0.631942895
Oklahoma,40129,Roger Mills County,1546,151,1758,1395,0.879408419,0.08589306,0.793515359
Oklahoma,40131,Rogers County,30893,7895,40834,22998,0.756550913,0.193343782,0.563207131
Oklahoma,40133,Seminole County,5612,2067,8032,3545,0.698705179,0.257345618,0.441359561
Oklahoma,40135,Sequoyah County,10888,3061,14437,7827,0.754173305,0.212024659,0.542148646
Oklahoma,40137,Stephens County,14166,3084,17886,11082,0.792016102,0.172425361,0.619590741
Oklahoma,40139,Texas County,4615,855,5771,3760,0.799688096,0.148154566,0.65153353
Oklahoma,40141,Tillman County,1944,657,2706,1287,0.718403548,0.242793792,0.475609756
Oklahoma,40143,Tulsa County,143985,87663,246557,56322,0.583982608,0.355548616,0.228433992
Oklahoma,40145,Wagoner County,22967,6711,31246,16256,0.735038085,0.214779492,0.520258593
Oklahoma,40147,Washington County,15810,5047,22208,10763,0.71190562,0.227260447,0.484645173
Oklahoma,40149,Washita County,3851,588,4628,3263,0.832108902,0.127052723,0.705056179
Oklahoma,40151,Woods County,2945,521,3665,2424,0.803547067,0.142155525,0.661391542
Oklahoma,40153,Woodward County,6329,871,7573,5458,0.835732207,0.115013865,0.720718342
Oregon,41001,Baker County,6160,1781,8479,4379,0.726500767,0.210048355,0.516452412
Oregon,41003,Benton County,13030,28431,45577,-15401,0.285889813,0.623801479,-0.337911666
Oregon,41005,Clackamas County,79062,90187,182136,-11125,0.434082224,0.495162955,-0.061080731
Oregon,41007,Clatsop County,7794,8899,18158,-1105,0.429232294,0.490087014,-0.06085472
Oregon,41009,Columbia County,12967,9959,25077,3008,0.517087371,0.397136819,0.119950552
Oregon,41011,Coos County,17699,10355,30181,7344,0.586428548,0.34309665,0.243331898
Oregon,41013,Crook County,8388,2591,11638,5797,0.720742396,0.222632755,0.498109641
Oregon,41015,Curry County,7157,4253,12163,2904,0.588423909,0.349667023,0.238756886
Oregon,41017,Deschutes County,43667,40222,90584,3445,0.48206085,0.444029851,0.038030999
Oregon,41019,Douglas County,34112,13891,51350,20221,0.664303797,0.270516066,0.393787731
Oregon,41021,Gilliam County,632,221,937,411,0.674493063,0.235859125,0.438633938
Oregon,41023,Grant County,3187,732,4171,2455,0.764085351,0.175497483,0.588587868
Oregon,41025,Harney County,2904,682,3850,2222,0.754285714,0.177142857,0.577142857
Oregon,41027,Hood River County,3223,6359,10383,-3136,0.310411249,0.612443417,-0.302032168
Oregon,41029,Jackson County,53083,43550,103789,9533,0.511451117,0.419601306,0.091849811
Oregon,41031,Jefferson County,5337,2892,8874,2445,0.601419878,0.325895876,0.275524002
Oregon,41033,Josephine County,26582,13223,42613,13359,0.623800249,0.310304367,0.313495882
Oregon,41035,Klamath County,20170,7080,29240,13090,0.689808482,0.242134063,0.447674419
Oregon,41037,Lake County,3001,628,3814,2373,0.786837965,0.164656529,0.622181436
Oregon,41039,Lane County,66218,100497,181072,-34279,0.365699832,0.555011266,-0.189311434
Oregon,41041,Lincoln County,9901,12300,24035,-2399,0.411940919,0.511753693,-0.099812774
Oregon,41043,Linn County,32683,17456,54724,15227,0.597233389,0.318982531,0.278250858
Oregon,41045,Malheur County,7141,2213,9950,4928,0.717688442,0.22241206,0.495276382
Oregon,41047,Marion County,54336,48803,110804,5533,0.490379409,0.440444388,0.049935021
Oregon,41049,Morrow County,2698,1004,3989,1694,0.67635999,0.251692153,0.424667837
Oregon,41051,Multnomah County,63055,271754,357762,-208699,0.176248456,0.759594367,-0.583345911
Oregon,41053,Polk County,18333,15741,37030,2592,0.495085066,0.425087767,0.069997299
Oregon,41055,Sherman County,726,202,983,524,0.738555443,0.205493388,0.533062055
Oregon,41057,Tillamook County,6486,5701,13261,785,0.489103386,0.429907247,0.059196139
Oregon,41059,Umatilla County,16775,7466,26116,9309,0.642326543,0.285878389,0.356448154
Oregon,41061,Union County,8378,3221,12465,5157,0.672121941,0.25840353,0.413718411
Oregon,41063,Wallowa County,2825,1097,4177,1728,0.67632272,0.262628681,0.413694039
Oregon,41065,Wasco County,5721,4634,11251,1087,0.508488134,0.4118745,0.096613634
Oregon,41067,Washington County,75903,137818,232034,-61915,0.327120163,0.593956058,-0.266835895
Oregon,41069,Wheeler County,583,153,792,430,0.736111111,0.193181818,0.542929293
Oregon,41071,Yamhill County,22589,18635,45116,3954,0.500687118,0.413046369,0.087640749
Pennsylvania,42001,Adams County,31249,14077,47138,17172,0.662925877,0.298633799,0.364292078
Pennsylvania,42003,Allegheny County,257488,363017,643173,-105529,0.400340188,0.564415795,-0.164075607
Pennsylvania,42005,Armstrong County,22676,6849,30446,15827,0.744794062,0.224955659,0.519838403
Pennsylvania,42007,Beaver County,46081,30225,79036,15856,0.583038109,0.382420669,0.20061744
Pennsylvania,42009,Bedford County,19455,3613,23504,15842,0.82773145,0.153718516,0.674012934
Pennsylvania,42011,Berks County,93094,75169,175934,17925,0.52914161,0.427256812,0.101884798
Pennsylvania,42013,Blair County,37224,13093,52029,24131,0.715447154,0.251648119,0.463799035
Pennsylvania,42015,Bradford County,17957,6263,25399,11694,0.706996338,0.246584511,0.460411827
Pennsylvania,42017,Bucks County,163873,165861,342572,-1988,0.478360753,0.484163913,-0.00580316
Pennsylvania,42019,Butler County,61388,26834,92027,34554,0.6670651,0.291588338,0.375476762
Pennsylvania,42021,Cambria County,40510,17798,60167,22712,0.673292669,0.295809996,0.377482673
Pennsylvania,42023,Cameron County,1495,469,2024,1026,0.738636364,0.231719368,0.506916996
Pennsylvania,42025,Carbon County,18714,8917,28721,9797,0.651578984,0.310469691,0.341109293
Pennsylvania,42027,Centre County,35099,36555,75394,-1456,0.465541024,0.484852906,-0.019311882
Pennsylvania,42029,Chester County,115582,140188,266637,-24606,0.433480725,0.525763491,-0.092282766
Pennsylvania,42031,Clarion County,12545,4256,17481,8289,0.717636291,0.243464333,0.474171958
Pennsylvania,42033,Clearfield County,23909,7700,32692,16209,0.731341001,0.235531629,0.495809372
Pennsylvania,42035,Clinton County,9701,4533,14839,5168,0.653750253,0.305478806,0.348271447
Pennsylvania,42037,Columbia County,17387,8502,27127,8885,0.640948133,0.313414679,0.327533454
Pennsylvania,42039,Crawford County,23912,10215,35563,13697,0.67238422,0.287236735,0.385147485
Pennsylvania,42041,Cumberland County,65649,44282,115068,21367,0.570523517,0.384833316,0.185690201
Pennsylvania,42043,Dauphin County,60620,64287,130160,-3667,0.465734481,0.493907498,-0.028173017
Pennsylvania,42045,Delaware County,106559,169169,284832,-62610,0.374111757,0.593925542,-0.219813785
Pennsylvania,42047,Elk County,9704,3637,13854,6067,0.700447524,0.262523459,0.437924065
Pennsylvania,42049,Erie County,57168,54820,117240,2348,0.487615148,0.467587854,0.020027294
Pennsylvania,42051,Fayette County,34388,17826,53426,16562,0.643656647,0.33365777,0.309998877
Pennsylvania,42053,Forest County,1680,626,2398,1054,0.70058382,0.261050876,0.439532944
Pennsylvania,42055,Franklin County,49554,17322,69345,32232,0.714600909,0.249794506,0.464806403
Pennsylvania,42057,Fulton County,5676,904,6743,4772,0.841761827,0.134064956,0.707696871
Pennsylvania,42059,Greene County,10394,4157,14955,6237,0.695018388,0.277967235,0.417051153
Pennsylvania,42061,Huntingdon County,14369,4487,19496,9882,0.737022979,0.230149774,0.506873205
Pennsylvania,42063,Indiana County,24920,11468,37728,13452,0.660517388,0.303965225,0.356552163
Pennsylvania,42065,Jefferson County,14533,3437,18551,11096,0.783407903,0.185273031,0.598134872
Pennsylvania,42067,Juniata County,8234,1810,10402,6424,0.791578543,0.174004999,0.617573544
Pennsylvania,42069,Lackawanna County,48102,51593,102740,-3491,0.468191551,0.502170528,-0.033978977
Pennsylvania,42071,Lancaster County,137145,90066,239151,47079,0.573466136,0.376607248,0.196858888
Pennsylvania,42073,Lawrence County,25323,13933,40555,11390,0.624411293,0.343558131,0.280853162
Pennsylvania,42075,Lebanon County,38804,17860,58906,20944,0.65874444,0.303194921,0.355549519
Pennsylvania,42077,Lehigh County,70285,77087,153031,-6802,0.459286027,0.503734537,-0.04444851
Pennsylvania,42079,Luzerne County,77508,51454,132731,26054,0.583947985,0.387656237,0.196291748
Pennsylvania,42081,Lycoming County,35475,12926,50294,22549,0.705352527,0.257008788,0.448343739
Pennsylvania,42083,McKean County,11159,3802,15572,7357,0.71660673,0.244156178,0.472450552
Pennsylvania,42085,Mercer County,30034,17631,49594,12403,0.605597451,0.355506715,0.250090736
Pennsylvania,42087,Mifflin County,14050,3563,18239,10487,0.770327321,0.195350622,0.574976699
Pennsylvania,42089,Monroe County,31706,31930,65944,-224,0.480801893,0.484198714,-0.003396821
Pennsylvania,42091,Montgomery County,160803,251063,427489,-90260,0.376157047,0.587296983,-0.211139936
Pennsylvania,42093,Montour County,5274,2851,8535,2423,0.617926186,0.334036321,0.283889865
Pennsylvania,42095,Northampton County,71384,65936,142775,5448,0.499975486,0.461817545,0.038157941
Pennsylvania,42097,Northumberland County,24418,9184,34971,15234,0.698235681,0.262617597,0.435618084
Pennsylvania,42099,Perry County,15613,4630,21153,10983,0.738098615,0.218881483,0.519217132
Pennsylvania,42101,Philadelphia County,105418,560542,680227,-455124,0.154974736,0.824051383,-0.669076647
Pennsylvania,42103,Pike County,16035,9247,26066,6788,0.615169186,0.354753318,0.260415868
Pennsylvania,42105,Potter County,6247,1300,7777,4947,0.803266041,0.167159573,0.636106468
Pennsylvania,42107,Schuylkill County,43937,16724,62750,27213,0.700191235,0.266517928,0.433673307
Pennsylvania,42109,Snyder County,11710,3991,16333,7719,0.716953407,0.244351926,0.472601481
Pennsylvania,42111,Somerset County,27347,7367,35730,19980,0.765379233,0.206185278,0.559193955
Pennsylvania,42113,Sullivan County,2318,756,3168,1562,0.731691919,0.238636364,0.493055555
Pennsylvania,42115,Susquehanna County,13295,5065,19200,8230,0.692447917,0.263802083,0.428645834
Pennsylvania,42117,Tioga County,12928,3642,17334,9286,0.745817469,0.210107304,0.535710165
Pennsylvania,42119,Union County,10605,6138,17400,4467,0.609482759,0.352758621,0.256724138
Pennsylvania,42121,Venango County,15254,5889,22096,9365,0.690351195,0.266518827,0.423832368
Pennsylvania,42123,Warren County,12032,4828,17624,7204,0.682705402,0.273944621,0.408760781
Pennsylvania,42125,Washington County,58941,34436,96945,24505,0.607983908,0.355211718,0.25277219
Pennsylvania,42127,Wayne County,15269,6398,22365,8871,0.682718533,0.286071987,0.396646546
Pennsylvania,42129,Westmoreland County,116427,59506,181740,56921,0.640623968,0.327423792,0.313200176
Pennsylvania,42131,Wyoming County,8375,3573,12418,4802,0.674424223,0.287727492,0.386696731
Pennsylvania,42133,York County,126933,67428,203153,59505,0.624814795,0.331907479,0.292907316
Rhode Island,44001,Bristol County,8910,14532,24691,-5622,0.360860232,0.588554534,-0.227694302
Rhode Island,44003,Kent County,38141,37582,79691,559,0.478611136,0.471596542,0.007014594
Rhode Island,44005,Newport County,14975,22680,39761,-7705,0.376625336,0.570408189,-0.193782853
Rhode Island,44007,Providence County,90321,141597,241818,-51276,0.373508176,0.585551944,-0.212043768
Rhode Island,44009,Washington County,27074,33511,64160,-6437,0.421976309,0.522303616,-0.100327307
South Carolina,45001,Abbeville County,6742,3712,10724,3030,0.628683327,0.3461395,0.282543827
South Carolina,45003,Aiken County,45981,25426,74773,20555,0.614941222,0.340042529,0.274898693
South Carolina,45005,Allendale County,788,2722,3578,-1934,0.220234768,0.760760201,-0.540525433
South Carolina,45007,Anderson County,56109,21040,80296,35069,0.698777025,0.262030487,0.436746538
South Carolina,45009,Bamberg County,2197,3886,6195,-1689,0.354640839,0.627280065,-0.272639226
South Carolina,45011,Barnwell County,4888,4395,9479,493,0.51566621,0.463656504,0.052009706
South Carolina,45013,Beaufort County,39986,29577,72770,10409,0.549484678,0.406444964,0.143039714
South Carolina,45015,Berkeley County,44223,30492,78919,13731,0.560359356,0.386370836,0.17398852
South Carolina,45017,Calhoun County,3785,3569,7553,216,0.501125381,0.472527473,0.028597908
South Carolina,45019,Charleston County,75233,89048,175850,-13815,0.427824851,0.506386125,-0.078561274
South Carolina,45021,Cherokee County,15165,6089,21754,9076,0.697113175,0.279902547,0.417210628
South Carolina,45023,Chester County,7272,6582,14202,690,0.512040558,0.463455851,0.048584707
South Carolina,45025,Chesterfield County,9576,7125,17128,2451,0.55908454,0.415985521,0.143099019
South Carolina,45027,Clarendon County,7246,7635,15156,-389,0.478094484,0.503760887,-0.025666403
South Carolina,45029,Colleton County,9083,7616,17231,1467,0.527131333,0.44199408,0.085137253
South Carolina,45031,Darlington County,14973,13866,29636,1107,0.505230126,0.467876906,0.03735322
South Carolina,45033,Dillon County,5637,5832,11696,-195,0.481959644,0.498632011,-0.016672367
South Carolina,45035,Dorchester County,34932,24010,62463,10922,0.559243072,0.384387557,0.174855515
South Carolina,45037,Edgefield County,6842,4491,11644,2351,0.587598763,0.385692202,0.201906561
South Carolina,45039,Fairfield County,4024,6936,11252,-2912,0.357625311,0.616423747,-0.258798436
South Carolina,45041,Florence County,29498,26630,57770,2868,0.510611044,0.460965899,0.049645145
South Carolina,45043,Georgetown County,17334,13234,31519,4100,0.549953996,0.419873727,0.130080269
South Carolina,45045,Greenville County,125595,73338,211572,52257,0.593627701,0.34663377,0.246993931
South Carolina,45047,Greenwood County,16881,10633,28600,6248,0.590244755,0.371783217,0.218461538
South Carolina,45049,Hampton County,3483,5163,8794,-1680,0.396065499,0.587104844,-0.191039345
South Carolina,45051,Horry County,83819,36731,124503,47088,0.673228758,0.295021004,0.378207754
South Carolina,45053,Jasper County,6100,7789,14216,-1689,0.429093979,0.54790377,-0.118809791
South Carolina,45055,Kershaw County,17464,10293,28875,7171,0.604813853,0.356467532,0.248346321
South Carolina,45057,Lancaster County,23598,13718,38717,9880,0.609499703,0.354314642,0.255185061
South Carolina,45059,Laurens County,16770,8845,26474,7925,0.633451688,0.334101382,0.299350306
South Carolina,45061,Lee County,2789,5170,8110,-2381,0.343896424,0.637484587,-0.293588163
South Carolina,45063,Lexington County,79866,35143,121829,44723,0.6555582,0.288461696,0.367096504
South Carolina,45067,Marion County,5434,8522,14217,-3088,0.382218471,0.599423226,-0.217204755
South Carolina,45069,Marlboro County,4257,5928,10353,-1671,0.411185164,0.572587656,-0.161402492
South Carolina,45065,McCormick County,2651,2479,5215,172,0.508341323,0.47535954,0.032981783
South Carolina,45071,Newberry County,10011,6212,16795,3799,0.596070259,0.369871986,0.226198273
South Carolina,45073,Oconee County,24096,7979,33530,16117,0.718640024,0.237966001,0.480674023
South Carolina,45075,Orangeburg County,11909,26258,38824,-14349,0.306743252,0.676334226,-0.369590974
South Carolina,45077,Pickens County,36096,10327,48871,25769,0.738597532,0.211311412,0.52728612
South Carolina,45079,Richland County,52753,108401,169400,-55648,0.311410862,0.639911452,-0.32850059
South Carolina,45081,Saluda County,5525,2809,8559,2716,0.645519336,0.328192546,0.31732679
South Carolina,45083,Spartanburg County,76101,39888,120793,36213,0.630011673,0.330217811,0.299793862
South Carolina,45085,Sumter County,18733,24024,44048,-5291,0.425286052,0.545405013,-0.120118961
South Carolina,45087,Union County,7058,4727,12087,2331,0.583933151,0.391081327,0.192851824
South Carolina,45089,Williamsburg County,4863,9949,15049,-5086,0.323144395,0.66110705,-0.337962655
South Carolina,45091,York County,66245,41230,113425,25015,0.584042319,0.36350011,0.220542209
South Dakota,46003,Aurora County,974,340,1407,634,0.692253021,0.241648898,0.450604123
South Dakota,46005,Beadle County,4455,1912,6772,2543,0.657855877,0.282339043,0.375516834
South Dakota,46007,Bennett County,666,412,1149,254,0.579634465,0.358572672,0.221061793
South Dakota,46009,Bon Homme County,2105,704,2974,1401,0.707800941,0.236718225,0.471082716
South Dakota,46011,Brookings County,6748,4879,12680,1869,0.532176656,0.38477918,0.147397476
South Dakota,46013,Brown County,9613,5452,16113,4161,0.596599019,0.33836033,0.258238689
South Dakota,46015,Brule County,1565,571,2288,994,0.684003497,0.249562937,0.43444056
South Dakota,46017,Buffalo County,171,296,490,-125,0.348979592,0.604081633,-0.255102041
South Dakota,46019,Butte County,3355,693,4346,2662,0.771974229,0.159456972,0.612517257
South Dakota,46021,Campbell County,704,105,831,599,0.847172082,0.126353791,0.720818291
South Dakota,46023,Charles Mix County,2382,935,3433,1447,0.693853772,0.272356539,0.421497233
South Dakota,46025,Clark County,1139,398,1657,741,0.687386844,0.24019312,0.447193724
South Dakota,46027,Clay County,2109,2608,5069,-499,0.416058394,0.514499901,-0.098441507
South Dakota,46029,Codington County,7764,3174,11669,4590,0.665352644,0.272002742,0.393349902
South Dakota,46031,Corson County,588,535,1175,53,0.500425532,0.455319149,0.045106383
South Dakota,46033,Custer County,3290,1120,4716,2170,0.697625106,0.237489398,0.460135708
South Dakota,46035,Davison County,5157,2355,7952,2802,0.648516097,0.296151911,0.352364186
South Dakota,46037,Day County,1627,974,2747,653,0.59228249,0.35456862,0.23771387
South Dakota,46039,Deuel County,1366,570,2080,796,0.656730769,0.274038462,0.382692307
South Dakota,46041,Dewey County,723,887,1707,-164,0.423550088,0.519625073,-0.096074985
South Dakota,46043,Douglas County,1338,214,1605,1124,0.83364486,0.133333333,0.700311527
South Dakota,46045,Edmunds County,1433,380,1918,1053,0.74713243,0.198123045,0.549009385
South Dakota,46047,Fall River County,2511,821,3563,1690,0.704743194,0.2304238,0.474319394
South Dakota,46049,Faulk County,858,204,1118,654,0.76744186,0.182468694,0.584973166
South Dakota,46051,Grant County,2381,970,3562,1411,0.668444694,0.272318922,0.396125772
South Dakota,46053,Gregory County,1600,391,2091,1209,0.765184122,0.18699187,0.578192252
South Dakota,46055,Haakon County,936,77,1044,859,0.896551724,0.073754789,0.822796935
South Dakota,46057,Hamlin County,2051,555,2762,1496,0.742577842,0.200941347,0.541636495
South Dakota,46059,Hand County,1391,334,1818,1057,0.765126513,0.183718372,0.581408141
South Dakota,46061,Hanson County,1497,424,2006,1073,0.746261216,0.211365902,0.534895314
South Dakota,46063,Harding County,694,38,769,656,0.902470741,0.049414824,0.853055917
South Dakota,46065,Hughes County,5174,2449,8173,2725,0.633060076,0.299645173,0.333414903
South Dakota,46067,Hutchinson County,2517,692,3365,1825,0.747994056,0.20564636,0.542347696
South Dakota,46069,Hyde County,543,125,690,418,0.786956522,0.18115942,0.605797102
South Dakota,46071,Jackson County,722,323,1095,399,0.659360731,0.294977169,0.364383562
South Dakota,46073,Jerauld County,648,264,967,384,0.670113754,0.273009307,0.397104447
South Dakota,46075,Jones County,450,69,558,381,0.806451613,0.123655914,0.682795699
South Dakota,46077,Kingsbury County,1680,703,2551,977,0.658565269,0.275578205,0.382987064
South Dakota,46079,Lake County,4038,2314,6786,1724,0.59504863,0.340996169,0.254052461
South Dakota,46081,Lawrence County,7411,3356,11842,4055,0.625823341,0.283398075,0.342425266
South Dakota,46083,Lincoln County,15499,8076,25231,7423,0.614284016,0.320082438,0.294201578
South Dakota,46085,Lyman County,977,369,1421,608,0.687543983,0.259676284,0.427867699
South Dakota,46091,Marshall County,1056,754,1947,302,0.542372881,0.387262455,0.155110426
South Dakota,46087,McCook County,1794,623,2587,1171,0.693467337,0.240819482,0.452647855
South Dakota,46089,McPherson County,892,192,1137,700,0.784520668,0.168865435,0.615655233
South Dakota,46093,Meade County,8441,2223,11621,6218,0.726357456,0.191291627,0.535065829
South Dakota,46095,Mellette County,402,238,683,164,0.588579795,0.348462665,0.24011713
South Dakota,46097,Miner County,706,281,1064,425,0.663533835,0.264097744,0.399436091
South Dakota,46099,Minnehaha County,42043,30610,78263,11433,0.537201487,0.391117131,0.146084356
South Dakota,46101,Moody County,1729,1042,2930,687,0.590102389,0.355631399,0.23447099
South Dakota,46102,Oglala Lakota County,241,2504,2896,-2263,0.083218232,0.864640884,-0.781422652
South Dakota,46103,Pennington County,29804,14074,47741,15730,0.624285206,0.29479902,0.329486186
South Dakota,46105,Perkins County,1333,188,1606,1145,0.830012453,0.117061021,0.712951432
South Dakota,46107,Potter County,1069,215,1335,854,0.800749064,0.161048689,0.639700375
South Dakota,46109,Roberts County,2142,1539,3886,603,0.55120947,0.396037056,0.155172414
South Dakota,46111,Sanborn County,819,241,1123,578,0.729296527,0.21460374,0.514692787
South Dakota,46115,Spink County,1854,919,2951,935,0.628261606,0.311419858,0.316841748
South Dakota,46117,Stanley County,1148,329,1567,819,0.732610083,0.209955329,0.522654754
South Dakota,46119,Sully County,679,137,861,542,0.788617886,0.159117305,0.629500581
South Dakota,46121,Todd County,487,1505,2125,-1018,0.229176471,0.708235294,-0.479058823
South Dakota,46123,Tripp County,2069,462,2630,1607,0.786692015,0.175665399,0.611026616
South Dakota,46125,Turner County,2937,961,4150,1976,0.707710843,0.231566265,0.476144578
South Dakota,46127,Union County,5288,2227,7895,3061,0.669791007,0.282077264,0.387713743
South Dakota,46129,Walworth County,1896,457,2477,1439,0.765442067,0.184497376,0.580944691
South Dakota,46135,Yankton County,5654,3301,9616,2353,0.587978369,0.34328203,0.244696339
South Dakota,46137,Ziebach County,368,352,766,16,0.480417755,0.459530026,0.020887729
Tennessee,47001,Anderson County,19201,9010,29723,10191,0.645998049,0.303132254,0.342865795
Tennessee,47003,Bedford County,11455,3384,15300,8071,0.74869281,0.221176471,0.527516339
Tennessee,47005,Benton County,4715,1474,6322,3241,0.745808289,0.233154065,0.512654224
Tennessee,47007,Bledsoe County,3621,896,4650,2725,0.778709677,0.192688172,0.586021505
Tennessee,47009,Blount County,37385,12085,51849,25300,0.721036086,0.233080677,0.487955409
Tennessee,47011,Bradley County,29761,7070,38392,22691,0.775187539,0.184152949,0.59103459
Tennessee,47013,Campbell County,9860,2248,12504,7612,0.788547665,0.17978247,0.608765195
Tennessee,47015,Cannon County,4006,1126,5299,2880,0.755991697,0.212492923,0.543498774
Tennessee,47017,Carroll County,7731,2323,10333,5408,0.748185425,0.224813704,0.523371721
Tennessee,47019,Carter County,16897,3453,20993,13444,0.804887343,0.164483399,0.640403944
Tennessee,47021,Cheatham County,11295,3877,15823,7418,0.713834292,0.245023068,0.468811224
Tennessee,47023,Chester County,3827,902,4850,2925,0.789072165,0.185979381,0.603092784
Tennessee,47025,Claiborne County,8589,1831,10706,6758,0.802260415,0.171025593,0.631234822
Tennessee,47027,Clay County,2140,707,2919,1433,0.733127783,0.242206235,0.490921548
Tennessee,47029,Cocke County,9791,1980,12108,7811,0.808638916,0.163528246,0.64511067
Tennessee,47031,Coffee County,14409,4741,19895,9668,0.724252325,0.238301081,0.485951244
Tennessee,47033,Crockett County,3977,1302,5386,2675,0.738395841,0.241737839,0.496658002
Tennessee,47035,Cumberland County,20410,5202,26298,15208,0.776104647,0.197809719,0.578294928
Tennessee,47037,Davidson County,84365,148473,246199,-64108,0.342669954,0.603060939,-0.260390985
Tennessee,47039,Decatur County,3580,894,4577,2686,0.782171728,0.195324448,0.58684728
Tennessee,47041,DeKalb County,5164,1566,6940,3598,0.744092219,0.225648415,0.518443804
Tennessee,47043,Dickson County,13213,4718,18619,8495,0.709651431,0.253397068,0.456254363
Tennessee,47045,Dyer County,10175,2815,13290,7360,0.765613243,0.211813394,0.553799849
Tennessee,47047,Fayette County,13046,5865,19306,7181,0.675748472,0.303791567,0.371956905
Tennessee,47049,Fentress County,6032,1100,7311,4932,0.825058132,0.150458214,0.674599918
Tennessee,47051,Franklin County,11526,4372,16363,7154,0.70439406,0.267188168,0.437205892
Tennessee,47053,Gibson County,13779,5255,19484,8524,0.707195648,0.269708479,0.437487169
Tennessee,47055,Giles County,7964,2915,11120,5049,0.71618705,0.262140288,0.454046762
Tennessee,47057,Grainger County,6618,1154,7985,5464,0.828804008,0.144520977,0.684283031
Tennessee,47059,Greene County,18538,4211,23491,14327,0.789153293,0.179260142,0.609893151
Tennessee,47061,Grundy County,3626,998,4750,2628,0.763368421,0.210105263,0.553263158
Tennessee,47063,Hamblen County,15839,4075,20579,11764,0.769668108,0.198017396,0.571650712
Tennessee,47065,Hamilton County,78661,55260,141088,23401,0.55753147,0.391670447,0.165861023
Tennessee,47067,Hancock County,1842,322,2229,1520,0.826379542,0.144459399,0.681920143
Tennessee,47069,Hardeman County,4912,4174,9242,738,0.531486691,0.451633845,0.079852846
Tennessee,47071,Hardin County,8012,1622,9949,6390,0.805307066,0.16303146,0.642275606
Tennessee,47073,Hawkins County,16611,3502,20694,13109,0.802696434,0.169227795,0.633468639
Tennessee,47075,Haywood County,3010,3704,6824,-694,0.44109027,0.542790152,-0.101699882
Tennessee,47077,Henderson County,8118,1796,10172,6322,0.798073142,0.176563114,0.621510028
Tennessee,47079,Henry County,9483,3061,12887,6422,0.735857841,0.237526189,0.498331652
Tennessee,47081,Hickman County,5685,1823,7762,3862,0.732414326,0.234862149,0.497552177
Tennessee,47083,Houston County,2180,865,3165,1315,0.68878357,0.273301738,0.415481832
Tennessee,47085,Humphreys County,4928,1967,7139,2961,0.690292758,0.275528786,0.414763972
Tennessee,47087,Jackson County,3229,1129,4447,2100,0.726107488,0.25387902,0.472228468
Tennessee,47089,Jefferson County,14760,3490,18994,11270,0.777087501,0.183742234,0.593345267
Tennessee,47091,Johnson County,5400,988,6556,4412,0.823672971,0.150701647,0.672971324
Tennessee,47093,Knox County,105724,62861,179266,42863,0.589760468,0.350657682,0.239102786
Tennessee,47095,Lake County,1357,577,1970,780,0.688832487,0.292893401,0.395939086
Tennessee,47097,Lauderdale County,4884,3656,8678,1228,0.562802489,0.421295229,0.14150726
Tennessee,47099,Lawrence County,12419,2821,15658,9598,0.793140886,0.180163495,0.612977391
Tennessee,47101,Lewis County,3579,890,4601,2689,0.777874375,0.19343621,0.584438165
Tennessee,47103,Lincoln County,10375,2550,13270,7825,0.781838734,0.192162773,0.589675961
Tennessee,47105,Loudon County,17588,4916,23304,12672,0.75472022,0.21095091,0.54376931
Tennessee,47111,Macon County,6260,1071,7490,5189,0.835781041,0.142990654,0.692790387
Tennessee,47113,Madison County,21321,15438,37764,5883,0.564585319,0.408802034,0.155783285
Tennessee,47115,Marion County,7680,2829,10832,4851,0.70901034,0.261170606,0.447839734
Tennessee,47117,Marshall County,8167,2848,11402,5319,0.716277846,0.24978074,0.466497106
Tennessee,47119,Maury County,23781,10026,35068,13755,0.678139614,0.285901677,0.392237937
Tennessee,47107,McMinn County,14673,3507,18694,11166,0.784904247,0.1876003,0.597303947
Tennessee,47109,McNairy County,7839,1847,10035,5992,0.781165919,0.184055805,0.597110114
Tennessee,47121,Meigs County,3337,856,4311,2481,0.774066342,0.198561819,0.575504523
Tennessee,47123,Monroe County,13361,3184,17050,10177,0.783636364,0.186744868,0.596891496
Tennessee,47125,Montgomery County,32320,21686,57278,10634,0.564265512,0.378609588,0.185655924
Tennessee,47127,Moore County,2325,496,2926,1829,0.794600137,0.169514696,0.625085441
Tennessee,47129,Morgan County,5429,1053,6664,4376,0.81467587,0.158013205,0.656662665
Tennessee,47131,Obion County,9525,2425,12223,7100,0.779268592,0.198396466,0.580872126
Tennessee,47133,Overton County,6055,1943,8195,4112,0.738865162,0.23709579,0.501769372
Tennessee,47135,Perry County,2167,597,2855,1570,0.759019264,0.20910683,0.549912434
Tennessee,47137,Pickett County,2019,536,2609,1483,0.773859716,0.205442698,0.568417018
Tennessee,47139,Polk County,5097,1252,6520,3845,0.781748466,0.19202454,0.589723926
Tennessee,47141,Putnam County,18981,6847,26958,12134,0.704095259,0.253987685,0.450107574
Tennessee,47143,Rhea County,8650,1942,10946,6708,0.790243011,0.177416408,0.612826603
Tennessee,47145,Roane County,15863,4833,21580,11030,0.735078777,0.223957368,0.511121409
Tennessee,47147,Robertson County,19393,6634,27042,12759,0.717143702,0.245322092,0.47182161
Tennessee,47149,Rutherford County,64428,36627,106518,27801,0.604855517,0.343857376,0.260998141
Tennessee,47151,Scott County,6044,934,7123,5110,0.848518882,0.131124526,0.717394356
Tennessee,47153,Sequatchie County,4434,1051,5667,3383,0.782424563,0.185459679,0.596964884
Tennessee,47155,Sevier County,28610,6293,36180,22317,0.79076838,0.173935876,0.616832504
Tennessee,47157,Shelby County,114948,206640,331861,-91692,0.346373934,0.622670335,-0.276296401
Tennessee,47159,Smith County,5485,1688,7410,3797,0.740215924,0.22780027,0.512415654
Tennessee,47161,Stewart County,3864,1222,5283,2642,0.731402612,0.231307969,0.500094643
Tennessee,47163,Sullivan County,45577,11910,59860,33667,0.761393251,0.19896425,0.562429001
Tennessee,47165,Sumner County,50105,18153,71080,31952,0.704909961,0.255388295,0.449521666
Tennessee,47167,Tipton County,16893,5779,23372,11114,0.722787951,0.247261681,0.47552627
Tennessee,47169,Trousdale County,2099,943,3142,1156,0.668045831,0.300127307,0.367918524
Tennessee,47171,Unicoi County,5666,1260,7166,4406,0.790678203,0.17583031,0.614847893
Tennessee,47173,Union County,5024,1010,6204,4014,0.809800129,0.162798195,0.647001934
Tennessee,47175,Van Buren County,1820,539,2417,1281,0.752999586,0.223003724,0.529995862
Tennessee,47177,Warren County,9535,3535,13565,6000,0.702911906,0.260597125,0.442314781
Tennessee,47179,Washington County,34179,13003,49411,21176,0.691728562,0.263160025,0.428568537
Tennessee,47181,Wayne County,5034,717,5842,4317,0.861691202,0.122731941,0.738959261
Tennessee,47183,Weakley County,9001,2770,12127,6231,0.742228086,0.228415931,0.513812155
Tennessee,47185,White County,7657,1842,9776,5815,0.783244681,0.188420622,0.594824059
Tennessee,47187,Williamson County,68160,30992,104700,37168,0.651002865,0.296007641,0.354995224
Tennessee,47189,Wilson County,39304,14356,56286,24948,0.698290872,0.255054543,0.443236329
Texas,48001,Anderson County,13165,3358,16887,9807,0.77959377,0.198851187,0.580742583
Texas,48003,Andrews County,3925,836,4926,3089,0.796792529,0.169711734,0.627080795
Texas,48005,Angelina County,21666,7538,29870,14128,0.725343154,0.252360228,0.472982926
Texas,48007,Aransas County,7730,2458,10467,5272,0.738511512,0.234833286,0.503678226
Texas,48009,Archer County,3785,394,4269,3391,0.886624502,0.092293277,0.794331225
Texas,48011,Armstrong County,924,70,1017,854,0.908554572,0.068829892,0.83972468
Texas,48013,Atascosa County,8598,4635,13605,3963,0.631973539,0.340683572,0.291289967
Texas,48015,Austin County,9637,2319,12255,7318,0.786372909,0.189228886,0.597144023
Texas,48017,Bailey County,1343,397,1784,946,0.752802691,0.222533632,0.530269059
Texas,48019,Bandera County,8159,1726,10213,6433,0.798883776,0.169000294,0.629883482
Texas,48021,Bastrop County,16314,10555,28250,5759,0.577486726,0.373628319,0.203858407
Texas,48023,Baylor County,1267,191,1492,1076,0.84919571,0.128016086,0.721179624
Texas,48025,Bee County,4743,3443,8458,1300,0.560770868,0.407070229,0.153700639
Texas,48027,Bell County,51780,37608,93999,14172,0.550856924,0.400089363,0.150767561
Texas,48029,Bexar County,240161,319191,586038,-79030,0.409804484,0.54465922,-0.134854736
Texas,48031,Blanco County,4212,1244,5669,2968,0.742988181,0.219439055,0.523549126
Texas,48033,Borden County,330,31,365,299,0.904109589,0.084931507,0.819178082
Texas,48035,Bosque County,6325,1277,7797,5048,0.81120944,0.163780941,0.647428499
Texas,48037,Bowie County,24913,8831,34470,16082,0.722744415,0.256193792,0.466550623
Texas,48039,Brazoria County,72653,43075,120296,29578,0.603951919,0.358075081,0.245876838
Texas,48041,Brazos County,38662,23041,66036,15621,0.585468532,0.348915743,0.236552789
Texas,48043,Brewster County,2073,1869,4226,204,0.490534785,0.442262186,0.048272599
Texas,48045,Briscoe County,625,91,734,534,0.851498638,0.123978202,0.727520436
Texas,48047,Brooks County,613,1937,2596,-1324,0.236132512,0.74614792,-0.510015408
Texas,48049,Brown County,12010,1621,13949,10389,0.86099362,0.116209047,0.744784573
Texas,48051,Burleson County,5316,1491,6945,3825,0.765442765,0.214686825,0.55075594
Texas,48053,Burnet County,14595,3785,19046,10810,0.766302636,0.198729392,0.567573244
Texas,48055,Caldwell County,6516,4663,11709,1853,0.556495004,0.39824067,0.158254334
Texas,48057,Calhoun County,4638,2118,6957,2520,0.666666667,0.30444157,0.362225097
Texas,48059,Callahan County,4858,568,5556,4290,0.87437005,0.102231821,0.772138229
Texas,48061,Cameron County,29432,59319,91804,-29887,0.320596052,0.646148316,-0.325552264
Texas,48063,Camp County,3201,1260,4542,1941,0.704755614,0.277410832,0.427344782
Texas,48065,Carson County,2617,249,2945,2368,0.888624788,0.084550085,0.804074703
Texas,48067,Cass County,9182,2250,11606,6932,0.791142512,0.193865242,0.59727727
Texas,48069,Castro County,1413,526,1996,887,0.707915832,0.263527054,0.444388778
Texas,48071,Chambers County,13278,2939,16661,10339,0.796950963,0.176399976,0.620550987
Texas,48073,Cherokee County,12896,3466,16701,9430,0.772169331,0.207532483,0.564636848
Texas,48075,Childress County,1802,253,2084,1549,0.864683301,0.121401152,0.743282149
Texas,48077,Clay County,4376,536,5011,3840,0.873278787,0.106964678,0.766314109
Texas,48079,Cochran County,679,190,901,489,0.753607103,0.210876804,0.542730299
Texas,48081,Coke County,1265,140,1423,1125,0.888966971,0.098383696,0.790583275
Texas,48083,Coleman County,3177,387,3635,2790,0.874002751,0.106464924,0.767537827
Texas,48085,Collin County,200395,139837,356545,60558,0.562046866,0.392200143,0.169846723
Texas,48087,Collingsworth County,983,145,1154,838,0.851819757,0.125649913,0.726169844
Texas,48089,Colorado County,6323,1977,8480,4346,0.745636792,0.233136792,0.5125
Texas,48091,Comal County,44996,14166,61567,30830,0.73084607,0.230090795,0.500755275
Texas,48093,Comanche County,4300,788,5208,3512,0.825652842,0.151305684,0.674347158
Texas,48095,Concho County,885,148,1067,737,0.829428304,0.138706654,0.69072165
Texas,48097,Cooke County,13174,2345,15894,10829,0.828866239,0.147539952,0.681326287
Texas,48099,Coryell County,12212,5057,18127,7155,0.673691179,0.278976113,0.394715066
Texas,48101,Cottle County,486,84,583,402,0.833619211,0.144082333,0.689536878
Texas,48103,Crane County,1047,299,1381,748,0.758146271,0.216509776,0.541636495
Texas,48105,Crockett County,980,372,1395,608,0.702508961,0.266666667,0.435842294
Texas,48107,Crosby County,1180,468,1712,712,0.689252336,0.273364486,0.41588785
Texas,48109,Culberson County,280,454,762,-174,0.367454068,0.595800525,-0.228346457
Texas,48111,Dallam County,1258,222,1535,1036,0.819543974,0.144625407,0.674918567
Texas,48113,Dallas County,261865,458845,750649,-196980,0.348851461,0.611264386,-0.262412925
Texas,48115,Dawson County,2636,835,3562,1801,0.740033689,0.234418866,0.505614823
Texas,48117,Deaf Smith County,2911,1185,4201,1726,0.692930255,0.282075696,0.410854559
Texas,48119,Delta County,1836,400,2279,1436,0.805616498,0.175515577,0.630100921
Texas,48121,Denton County,169175,110000,293287,59175,0.576824067,0.375059242,0.201764825
Texas,48123,DeWitt County,5510,1161,6822,4349,0.807681032,0.170184697,0.637496335
Texas,48125,Dickens County,755,128,909,627,0.830583058,0.140814081,0.689768977
Texas,48127,Dimmit County,974,2173,3225,-1199,0.302015504,0.67379845,-0.371782946
Texas,48129,Donley County,1225,190,1460,1035,0.839041096,0.130136986,0.70890411
Texas,48131,Duval County,1316,2783,4159,-1467,0.316422217,0.669151238,-0.352729021
Texas,48133,Eastland County,6008,776,6935,5232,0.866330209,0.111896179,0.75443403
Texas,48135,Ector County,24976,10225,36373,14751,0.686663184,0.281115113,0.405548071
Texas,48137,Edwards County,741,302,1065,439,0.695774648,0.283568075,0.412206573
Texas,48139,Ellis County,44807,16197,63064,28610,0.710500444,0.256834327,0.453666117
Texas,48141,El Paso County,54567,145509,210458,-90942,0.259277386,0.691392107,-0.432114721
Texas,48143,Erath County,11205,2159,13810,9046,0.811368573,0.156335988,0.655032585
Texas,48145,Falls County,3438,1682,5232,1756,0.657110092,0.32148318,0.335626912
Texas,48147,Fannin County,9536,2123,11972,7413,0.796525226,0.177330438,0.619194788
Texas,48149,Fayette County,8648,2127,11029,6521,0.784114607,0.1928552,0.591259407
Texas,48151,Fisher County,1265,403,1722,862,0.734610918,0.234030197,0.500580721
Texas,48153,Floyd County,1473,435,1958,1038,0.752298264,0.222165475,0.530132789
Texas,48155,Foard County,383,113,511,270,0.749510763,0.221135029,0.528375734
Texas,48157,Fort Bend County,117212,134475,260367,-17263,0.450179938,0.516482504,-0.066302566
Texas,48159,Franklin County,3583,665,4356,2918,0.822543618,0.152662994,0.669880624
Texas,48161,Freestone County,5995,1461,7608,4534,0.78798633,0.1920347,0.59595163
Texas,48163,Frio County,1232,1401,2683,-169,0.459187477,0.522176668,-0.062989191
Texas,48165,Gaines County,3907,597,4609,3310,0.847689304,0.129529182,0.718160122
Texas,48167,Galveston County,73566,45503,123994,28063,0.593302902,0.366977434,0.226325468
Texas,48169,Garza County,1223,224,1475,999,0.829152542,0.151864407,0.677288135
Texas,48171,Gillespie County,10445,2286,13123,8159,0.795930809,0.174197973,0.621732836
Texas,48173,Glasscock County,553,34,602,519,0.918604651,0.056478405,0.862126246
Texas,48175,Goliad County,2618,973,3713,1645,0.705090224,0.262052249,0.443037975
Texas,48177,Gonzales County,4580,1567,6304,3013,0.726522843,0.248572335,0.477950508
Texas,48179,Gray County,6495,699,7360,5796,0.882472826,0.094972826,0.7875
Texas,48181,Grayson County,35274,10276,47068,24998,0.749426362,0.218322427,0.531103935
Texas,48183,Gregg County,28693,11623,41365,17070,0.693654055,0.280986341,0.412667714
Texas,48185,Grimes County,7065,2194,9528,4871,0.741498741,0.230268682,0.511230059
Texas,48187,Guadalupe County,36495,18308,57220,18187,0.637801468,0.319958057,0.317843411
Texas,48189,Hale County,6347,2090,8802,4257,0.721086117,0.237446035,0.483640082
Texas,48191,Hall County,891,164,1089,727,0.818181818,0.150596878,0.66758494
Texas,48193,Hamilton County,3056,479,3609,2577,0.846771959,0.132723746,0.714048213
Texas,48195,Hansford County,1730,171,1947,1559,0.888546482,0.087827427,0.800719055
Texas,48197,Hardeman County,1207,249,1511,958,0.798808736,0.164791529,0.634017207
Texas,48199,Hardin County,19600,2779,22768,16821,0.860857344,0.122057273,0.738800071
Texas,48201,Harris County,544960,706471,1302887,-161511,0.418271116,0.542235052,-0.123963936
Texas,48203,Harrison County,18712,7130,26364,11582,0.709755728,0.270444546,0.439311182
Texas,48205,Hartley County,1727,172,1945,1555,0.887917738,0.088431877,0.799485861
Texas,48207,Haskell County,1403,314,1765,1089,0.79490085,0.177903683,0.616997167
Texas,48209,Hays County,33730,33117,71524,613,0.471589956,0.463019406,0.00857055
Texas,48211,Hemphill County,1460,181,1687,1279,0.865441612,0.107291049,0.758150563
Texas,48213,Henderson County,23574,5649,29855,17925,0.78961648,0.189214537,0.600401943
Texas,48215,Hidalgo County,48608,118739,172990,-70131,0.28098734,0.686392277,-0.405404937
Texas,48217,Hill County,10075,2535,12906,7540,0.780644661,0.19642027,0.584224391
Texas,48219,Hockley County,5793,1257,7282,4536,0.795523208,0.172617413,0.622905795
Texas,48221,Hood County,21367,4001,26120,17366,0.818032159,0.153177642,0.664854517
Texas,48223,Hopkins County,10704,2508,13476,8196,0.79430098,0.186108638,0.608192342
Texas,48225,Houston County,6205,1978,8302,4227,0.747410263,0.238255842,0.509154421
Texas,48227,Howard County,6635,1768,8692,4867,0.763345605,0.20340543,0.559940175
Texas,48229,Hudspeth County,503,324,871,179,0.57749713,0.371986223,0.205510907
Texas,48231,Hunt County,23866,6301,31185,17565,0.765303832,0.202052269,0.563251563
Texas,48233,Hutchinson County,7039,854,8126,6185,0.866231848,0.105094758,0.76113709
Texas,48235,Irion County,660,90,760,570,0.868421053,0.118421053,0.75
Texas,48237,Jack County,2973,314,3339,2659,0.890386343,0.094040132,0.796346211
Texas,48239,Jackson County,4266,904,5275,3362,0.808720379,0.171374408,0.637345971
Texas,48241,Jasper County,10578,2582,13351,7996,0.792300202,0.193393753,0.598906449
Texas,48243,Jeff Davis County,694,422,1175,272,0.590638298,0.359148936,0.231489362
Texas,48245,Jefferson County,42828,42404,87363,424,0.490230418,0.485377105,0.004853313
Texas,48247,Jim Hogg County,430,1635,2119,-1205,0.202925908,0.771590373,-0.568664465
Texas,48249,Jim Wells County,5411,6688,12346,-1277,0.438279605,0.541713915,-0.10343431
Texas,48251,Johnson County,44370,10976,57270,33394,0.774751179,0.191653571,0.583097608
Texas,48253,Jones County,4815,935,5932,3880,0.811699258,0.15761969,0.654079568
Texas,48255,Karnes County,2959,1144,4185,1815,0.707048984,0.273357228,0.433691756
Texas,48257,Kaufman County,29537,10265,40979,19272,0.720783816,0.250494156,0.47028966
Texas,48259,Kendall County,15663,3633,19936,12030,0.785664125,0.182233146,0.603430979
Texas,48261,Kenedy County,84,99,186,-15,0.451612903,0.532258065,-0.080645162
Texas,48263,Kent County,360,59,433,301,0.831408776,0.136258661,0.695150115
Texas,48265,Kerr County,17658,4665,23090,12993,0.764746644,0.202035513,0.562711131
Texas,48267,Kimble County,1697,206,1945,1491,0.872493573,0.105912596,0.766580977
Texas,48269,King County,149,5,159,144,0.937106918,0.031446541,0.905660377
Texas,48271,Kinney County,936,457,1424,479,0.657303371,0.320926966,0.336376405
Texas,48273,Kleberg County,4364,4713,9483,-349,0.460191922,0.496994622,-0.0368027
Texas,48275,Knox County,1078,247,1358,831,0.793814433,0.181885125,0.611929308
Texas,48277,Lamar County,14546,3579,18537,10967,0.784700869,0.193073313,0.591627556
Texas,48279,Lamb County,3040,770,3905,2270,0.778489117,0.197183099,0.581306018
Texas,48281,Lampasas County,6371,1479,8149,4892,0.781813719,0.181494662,0.600319057
Texas,48283,La Salle County,870,1125,2049,-255,0.424597365,0.549048316,-0.124450951
Texas,48285,Lavaca County,7339,1170,8633,6169,0.850110043,0.135526468,0.714583575
Texas,48287,Lee County,4996,1372,6522,3624,0.766022692,0.210364919,0.555657773
Texas,48289,Leon County,6391,909,7407,5482,0.862832456,0.12272175,0.740110706
Texas,48291,Liberty County,18856,4851,24155,14005,0.780625129,0.200827986,0.579797143
Texas,48293,Limestone County,5747,1748,7648,3999,0.751438285,0.228556485,0.5228818
Texas,48295,Lipscomb County,1159,135,1322,1024,0.876701967,0.102118003,0.774583964
Texas,48297,Live Oak County,3450,739,4267,2711,0.808530584,0.173189595,0.635340989
Texas,48299,Llano County,8283,1825,10377,6458,0.798207574,0.175869712,0.622337862
Texas,48301,Loving County,57,4,64,53,0.890625,0.0625,0.828125
Texas,48303,Lubbock County,65566,27956,98060,37610,0.66863145,0.285090761,0.383540689
Texas,48305,Lynn County,1546,403,1997,1143,0.774161242,0.201802704,0.572358538
Texas,48313,Madison County,3349,881,4283,2468,0.781928555,0.205696941,0.576231614
Texas,48315,Marion County,2968,1156,4206,1812,0.705658583,0.274845459,0.430813124
Texas,48317,Martin County,1453,266,1755,1187,0.827920228,0.151566952,0.676353276
Texas,48319,Mason County,1656,353,2053,1303,0.806624452,0.171943497,0.634680955
Texas,48321,Matagorda County,8147,3357,11779,4790,0.69165464,0.284998727,0.406655913
Texas,48323,Maverick County,2816,10397,13588,-7581,0.207241684,0.765160436,-0.557918752
Texas,48307,McCulloch County,2546,480,3086,2066,0.825016202,0.155541154,0.669475048
Texas,48309,McLennan County,48245,27046,78255,21199,0.616510127,0.345613699,0.270896428
Texas,48311,McMullen County,454,40,497,414,0.913480885,0.080482897,0.832997988
Texas,48325,Medina County,12054,4624,17187,7430,0.701344039,0.269040554,0.432303485
Texas,48327,Menard County,681,153,860,528,0.791860465,0.177906977,0.613953488
Texas,48329,Midland County,36896,9993,48753,26903,0.756794454,0.204972002,0.551822452
Texas,48331,Milam County,6340,2042,8607,4298,0.736609736,0.237248751,0.499360985
Texas,48333,Mills County,1949,242,2238,1707,0.870866845,0.108132261,0.762734584
Texas,48335,Mitchell County,1780,353,2190,1427,0.812785388,0.161187215,0.651598173
Texas,48337,Montague County,7526,885,8604,6641,0.874709437,0.102859135,0.771850302
Texas,48339,Montgomery County,150188,45744,203083,104444,0.739539991,0.225247805,0.514292186
Texas,48341,Moore County,3974,1096,5262,2878,0.75522615,0.208285823,0.546940327
Texas,48343,Morris County,3443,1425,4964,2018,0.693593876,0.287066882,0.406526994
Texas,48345,Motley County,571,40,620,531,0.920967742,0.064516129,0.856451613
Texas,48347,Nacogdoches County,14751,6822,22430,7929,0.65764601,0.304146233,0.353499777
Texas,48349,Navarro County,11984,3998,16382,7986,0.731534611,0.244048346,0.487486265
Texas,48351,Newton County,2961,978,4010,1983,0.73840399,0.243890274,0.494513716
Texas,48353,Nolan County,3551,1029,4744,2522,0.748524452,0.216905565,0.531618887
Texas,48355,Nueces County,50704,49102,103958,1602,0.487735432,0.472325362,0.01541007
Texas,48357,Ochiltree County,2628,274,2981,2354,0.881583361,0.091915465,0.789667896
Texas,48359,Oldham County,850,78,945,772,0.899470899,0.082539683,0.816931216
Texas,48361,Orange County,25385,5716,31761,19669,0.799250653,0.179969145,0.619281508
Texas,48363,Palo Pinto County,8222,1700,10175,6522,0.808058968,0.167076167,0.640982801
Texas,48365,Panola County,8445,1835,10413,6610,0.811005474,0.17622203,0.634783444
Texas,48367,Parker County,46433,8329,56413,38104,0.823090422,0.147643274,0.675447148
Texas,48369,Parmer County,1911,848,2818,1063,0.678140525,0.30092264,0.377217885
Texas,48371,Pecos County,2463,1551,4167,912,0.591072714,0.372210223,0.218862491
Texas,48373,Polk County,26587,7123,34444,19464,0.771890605,0.206799443,0.565091162
Texas,48375,Potter County,19499,7620,28330,11879,0.688280974,0.26897282,0.419308154
Texas,48377,Presidio County,652,1458,2203,-806,0.295960054,0.661824784,-0.36586473
Texas,48379,Rains County,3919,619,4630,3300,0.846436285,0.133693305,0.71274298
Texas,48381,Randall County,43379,8340,53813,35039,0.806106331,0.154981138,0.651125193
Texas,48383,Reagan County,709,167,900,542,0.787777778,0.185555556,0.602222222
Texas,48385,Real County,1382,262,1678,1120,0.823599523,0.15613826,0.667461263
Texas,48387,Red River County,3924,1148,5147,2776,0.762385856,0.223042549,0.539343307
Texas,48389,Reeves County,1417,1659,3184,-242,0.445037688,0.521042714,-0.076005026
Texas,48391,Refugio County,1830,1034,2945,796,0.62139219,0.351103565,0.270288625
Texas,48393,Roberts County,524,20,550,504,0.952727273,0.036363636,0.916363637
Texas,48395,Robertson County,4665,2203,7010,2462,0.665477889,0.314265335,0.351212554
Texas,48397,Rockwall County,28396,9633,39529,18763,0.718358673,0.243694503,0.47466417
Texas,48399,Runnels County,3241,452,3765,2789,0.860823373,0.120053121,0.740770252
Texas,48401,Rusk County,14675,3935,18994,10740,0.772612404,0.207170685,0.565441719
Texas,48403,Sabine County,3992,614,4642,3378,0.859974149,0.132270573,0.727703576
Texas,48405,San Augustine County,2620,907,3563,1713,0.735335392,0.254560763,0.480774629
Texas,48407,San Jacinto County,8050,2034,10305,6016,0.781174187,0.197379913,0.583794274
Texas,48409,San Patricio County,13004,7825,21513,5179,0.604471715,0.363733556,0.240738159
Texas,48411,San Saba County,2025,293,2354,1732,0.860237893,0.124468989,0.735768904
Texas,48413,Schleicher County,819,209,1054,610,0.777039848,0.19829222,0.578747628
Texas,48415,Scurry County,4403,733,5261,3670,0.836913134,0.139327124,0.69758601
Texas,48417,Shackelford County,1378,103,1502,1275,0.917443409,0.068575233,0.848868176
Texas,48419,Shelby County,7171,1757,9072,5414,0.790454145,0.19367284,0.596781305
Texas,48421,Sherman County,807,96,933,711,0.864951768,0.102893891,0.762057877
Texas,48423,Smith County,58631,22128,83161,36503,0.705030002,0.266086266,0.438943736
Texas,48425,Somervell County,3206,540,3876,2666,0.827141383,0.139318885,0.687822498
Texas,48427,Starr County,2218,9246,11691,-7028,0.189718587,0.790864768,-0.601146181
Texas,48429,Stephens County,3033,348,3453,2685,0.878366638,0.100781929,0.777584709
Texas,48431,Sterling County,549,70,633,479,0.867298578,0.110584518,0.75671406
Texas,48433,Stonewall County,555,135,701,420,0.791726106,0.192582026,0.59914408
Texas,48435,Sutton County,1075,313,1415,762,0.759717314,0.221201413,0.538515901
Texas,48437,Swisher County,1671,462,2190,1209,0.763013699,0.210958904,0.552054795
Texas,48439,Tarrant County,345683,288001,662832,57682,0.521524308,0.434500748,0.08702356
Texas,48441,Taylor County,33172,10047,45266,23125,0.732823753,0.221954668,0.510869085
Texas,48443,Terrell County,287,140,437,147,0.656750572,0.320366133,0.336384439
Texas,48445,Terry County,1295,424,1763,871,0.734543392,0.240499149,0.494044243
Texas,48447,Throckmorton County,715,84,808,631,0.88490099,0.103960396,0.780940594
Texas,48449,Titus County,6405,2538,9176,3867,0.698016565,0.276591107,0.421425458
Texas,48451,Tom Green County,27376,9117,38104,18259,0.718454755,0.239266219,0.479188536
Texas,48453,Travis County,126750,306475,462511,-179725,0.274047536,0.662632889,-0.388585353
Texas,48455,Trinity County,4737,1154,5982,3583,0.791875627,0.19291207,0.598963557
Texas,48457,Tyler County,6601,1243,7969,5358,0.828334797,0.15597942,0.672355377
Texas,48459,Upshur County,13198,2378,15918,10820,0.829124262,0.149390627,0.679733635
Texas,48461,Upton County,961,284,1296,677,0.741512346,0.219135802,0.522376544
Texas,48463,Uvalde County,4828,3863,8936,965,0.540286482,0.432296329,0.107990153
Texas,48465,Val Verde County,5856,6920,13476,-1064,0.434550312,0.513505491,-0.078955179
Texas,48467,Van Zandt County,18436,2792,21689,15644,0.850016137,0.128728849,0.721287288
Texas,48469,Victoria County,21253,8843,31032,12410,0.684873679,0.284963908,0.399909771
Texas,48471,Walker County,12878,6085,19683,6793,0.654270182,0.309150028,0.345120154
Texas,48473,Waller County,10525,5744,16715,4781,0.629673946,0.343643434,0.286030512
Texas,48475,Ward County,2541,780,3413,1761,0.744506299,0.228537943,0.515968356
Texas,48477,Washington County,10944,3381,14747,7563,0.742117041,0.22926697,0.512850071
Texas,48479,Webb County,12946,42297,56867,-29351,0.227654,0.743788137,-0.516134137
Texas,48481,Wharton County,10149,4238,14707,5911,0.690079554,0.2881621,0.401917454
Texas,48483,Wheeler County,2087,194,2306,1893,0.905030356,0.084128361,0.820901995
Texas,48485,Wichita County,27609,8752,37913,18857,0.728219872,0.230844301,0.497375571
Texas,48487,Wilbarger County,3166,807,4101,2359,0.772006828,0.196781273,0.575225555
Texas,48489,Willacy County,1541,3416,5082,-1875,0.303227076,0.672176309,-0.368949233
Texas,48491,Williamson County,104029,84252,200524,19777,0.518785781,0.420159183,0.098626598
Texas,48493,Wilson County,13991,4790,19255,9201,0.726616463,0.248766554,0.477849909
Texas,48495,Winkler County,1403,420,1873,983,0.74906567,0.224239188,0.524826482
Texas,48497,Wise County,20655,3412,24661,17243,0.837557277,0.138356109,0.699201168
Texas,48499,Wood County,15681,2624,18646,13057,0.840984662,0.140727234,0.700257428
Texas,48501,Yoakum County,1797,426,2299,1371,0.781644193,0.185297956,0.596346237
Texas,48503,Young County,6587,873,7658,5714,0.860146252,0.113998433,0.746147819
Texas,48505,Zapata County,1028,2056,3134,-1028,0.328015316,0.656030632,-0.328015316
Texas,48507,Zavala County,692,2633,3390,-1941,0.204129794,0.776696165,-0.572566371
Utah,49001,Beaver County,1838,264,2490,1574,0.73815261,0.106024096,0.632128514
Utah,49003,Box Elder County,10324,1814,16548,8510,0.62388204,0.109620498,0.514261542
Utah,49005,Cache County,16643,6705,35879,9938,0.463864656,0.186878118,0.276986538
Utah,49007,Carbon County,5182,1696,7818,3486,0.662829368,0.216935278,0.44589409
Utah,49009,Daggett County,327,76,465,251,0.703225806,0.16344086,0.539784946
Utah,49011,Davis County,46985,22575,104661,24410,0.448925579,0.215696391,0.233229188
Utah,49013,Duchesne County,5505,500,6932,5005,0.794143104,0.072129256,0.722013848
Utah,49015,Emery County,3402,379,4263,3023,0.798029557,0.088904527,0.70912503
Utah,49017,Garfield County,1577,352,2294,1225,0.68744551,0.153443766,0.534001744
Utah,49019,Grand County,1934,1932,4456,2,0.434021544,0.433572711,0.000448833
Utah,49021,Iron County,10025,2104,15354,7921,0.652924319,0.137032695,0.515891624
Utah,49023,Juab County,2759,436,4076,2323,0.676889107,0.106967615,0.569921492
Utah,49025,Kane County,2248,739,3482,1509,0.645605974,0.212234348,0.433371626
Utah,49027,Millard County,3860,431,5234,3429,0.737485671,0.082346198,0.655139473
Utah,49029,Morgan County,3156,572,5136,2584,0.614485981,0.111370717,0.503115264
Utah,49031,Piute County,537,31,617,506,0.870340357,0.050243112,0.820097245
Utah,49033,Rich County,786,104,1096,682,0.717153285,0.094890511,0.622262774
Utah,49035,Salt Lake County,117901,154831,361347,-36930,0.32628194,0.428482871,-0.102200931
Utah,49037,San Juan County,2635,1997,5385,638,0.489322191,0.37084494,0.118477251
Utah,49039,Sanpete County,6436,1026,9778,5410,0.658212313,0.104929433,0.55328288
Utah,49041,Sevier County,6455,673,8308,5782,0.776961964,0.081006259,0.695955705
Utah,49043,Summit County,7160,10251,20133,-3091,0.355635027,0.509164059,-0.153529032
Utah,49045,Tooele County,9693,4015,18905,5678,0.512721502,0.212377678,0.300343824
Utah,49047,Uintah County,9876,1002,12883,8874,0.766591632,0.077776915,0.688814717
Utah,49049,Utah County,89755,24579,174942,65176,0.513055756,0.140497994,0.372557762
Utah,49051,Wasatch County,6115,3063,12120,3052,0.504537954,0.252722772,0.251815182
Utah,49053,Washington County,39566,9583,57494,29983,0.688176158,0.166678262,0.521497896
Utah,49055,Wayne County,959,271,1410,688,0.680141844,0.192198582,0.487943262
Utah,49057,Weber County,38447,22187,81451,16260,0.472026126,0.272396901,0.199629225
Virginia,51001,Accomack County,8582,6737,15755,1845,0.544715963,0.427610282,0.117105681
Virginia,51003,Albemarle County,19232,33297,56134,-14065,0.342608758,0.593169915,-0.250561157
Virginia,51510,Alexandria city,13241,57147,74384,-43906,0.178008712,0.768270058,-0.590261346
Virginia,51005,Alleghany County,4873,2165,7306,2708,0.666986039,0.296331782,0.370654257
Virginia,51007,Amelia County,4704,2150,7035,2554,0.668656716,0.305614783,0.363041933
Virginia,51009,Amherst County,9643,4986,15164,4657,0.635914007,0.328805065,0.307108942
Virginia,51011,Appomattox County,5714,2023,7954,3691,0.718380689,0.25433744,0.464043249
Virginia,51013,Arlington County,20155,91879,119344,-71724,0.168881552,0.769866939,-0.600985387
Virginia,51015,Augusta County,26152,8108,36661,18044,0.713346608,0.221161452,0.492185156
Virginia,51017,Bath County,1548,603,2243,945,0.690147124,0.26883638,0.421310744
Virginia,51019,Bedford County,30578,9733,42186,20845,0.724837624,0.230716351,0.494121273
Virginia,51021,Bland County,2572,453,3124,2119,0.823303457,0.145006402,0.678297055
Virginia,51023,Botetourt County,13369,4492,18641,8877,0.717182555,0.240974197,0.476208358
Virginia,51520,Bristol city,4884,1832,6966,3052,0.701119724,0.262991674,0.43812805
Virginia,51025,Brunswick County,3045,4473,7645,-1428,0.398299542,0.585088293,-0.186788751
Virginia,51027,Buchanan County,7292,1721,9220,5571,0.790889371,0.186659436,0.604229935
Virginia,51029,Buckingham County,3969,3128,7284,841,0.544892916,0.429434377,0.115458539
Virginia,51530,Buena Vista city,1432,693,2395,739,0.597912317,0.289352818,0.308559499
Virginia,51031,Campbell County,19442,6597,27218,12845,0.714306709,0.242376369,0.47193034
Virginia,51033,Caroline County,7143,6425,14189,718,0.503418141,0.452815561,0.05060258
Virginia,51035,Carroll County,10653,2557,13587,8096,0.784058291,0.188194598,0.595863693
Virginia,51036,Charles City County,1381,2244,3745,-863,0.368758344,0.599198932,-0.230440588
Virginia,51037,Charlotte County,3479,2153,5792,1326,0.600656077,0.371719613,0.228936464
Virginia,51540,Charlottesville city,2951,17865,22211,-14914,0.132862095,0.804331187,-0.671469092
Virginia,51550,Chesapeake city,53988,52554,111827,1434,0.482781439,0.46995806,0.012823379
Virginia,51041,Chesterfield County,84938,80993,175288,3945,0.484562548,0.462056729,0.022505819
Virginia,51043,Clarke County,4657,3047,8131,1610,0.57274628,0.374738655,0.198007625
Virginia,51570,Colonial Heights city,5681,2367,8427,3314,0.674142637,0.280882876,0.393259761
Virginia,51580,Covington city,1349,914,2369,435,0.569438582,0.3858168,0.183621782
Virginia,51045,Craig County,2139,541,2784,1598,0.768318966,0.194324713,0.573994253
Virginia,51047,Culpeper County,13341,7744,22087,5597,0.604020465,0.350613483,0.253406982
Virginia,51049,Cumberland County,2693,2032,4875,661,0.552410256,0.416820513,0.135589743
Virginia,51590,Danville city,7306,11051,18862,-3745,0.387339625,0.585886969,-0.198547344
Virginia,51051,Dickenson County,4932,1335,6405,3597,0.770023419,0.208430913,0.561592506
Virginia,51053,Dinwiddie County,7447,5765,13533,1682,0.55028449,0.425995714,0.124288776
Virginia,51595,Emporia city,792,1531,2367,-739,0.33460076,0.646810308,-0.312209548
Virginia,51057,Essex County,2657,2541,5354,116,0.496264475,0.474598431,0.021666044
Virginia,51059,Fairfax County,157837,354485,542858,-196648,0.290751909,0.652997653,-0.362245744
Virginia,51600,Fairfax city,3695,7363,11854,-3668,0.311709128,0.621140543,-0.309431415
Virginia,51610,Falls Church city,1323,5810,7667,-4487,0.172557715,0.757793139,-0.585235424
Virginia,51061,Fauquier County,22110,12960,37124,9150,0.595571598,0.349100312,0.246471286
Virginia,51063,Floyd County,5289,2300,7972,2989,0.663447065,0.288509784,0.374937281
Virginia,51065,Fluvanna County,7018,5751,13492,1267,0.520160095,0.426252594,0.093907501
Virginia,51067,Franklin County,18560,7254,26805,11306,0.692408133,0.270621153,0.42178698
Virginia,51620,Franklin city,1421,2516,4040,-1095,0.351732673,0.622772277,-0.271039604
Virginia,51069,Frederick County,26069,11920,40133,14149,0.649565196,0.297012434,0.352552762
Virginia,51630,Fredericksburg city,3731,6690,11135,-2959,0.3350696,0.600808262,-0.265738662
Virginia,51640,Galax city,1603,680,2363,923,0.678374947,0.287769784,0.390605163
Virginia,51071,Giles County,5930,1949,8196,3981,0.72352367,0.237798926,0.485724744
Virginia,51073,Gloucester County,13087,5399,19524,7688,0.670303217,0.276531448,0.393771769
Virginia,51075,Goochland County,8374,4884,13930,3490,0.6011486,0.350610194,0.250538406
Virginia,51077,Grayson County,5593,1407,7258,4186,0.770597961,0.193855056,0.576742905
Virginia,51079,Greene County,5943,2923,9503,3020,0.625381458,0.307587078,0.31779438
Virginia,51081,Greensville County,1737,2558,4363,-821,0.398120559,0.586293835,-0.188173276
Virginia,51083,Halifax County,9698,6890,16946,2808,0.572288446,0.406585625,0.165702821
Virginia,51650,Hampton city,17802,41030,61489,-23228,0.289515198,0.667273821,-0.377758623
Virginia,51085,Hanover County,39592,19360,62313,20232,0.635373036,0.310689583,0.324683453
Virginia,51660,Harrisonburg city,6232,10100,17693,-3868,0.352229695,0.570847228,-0.218617533
Virginia,51087,Henrico County,59674,93615,161966,-33941,0.368435351,0.577991677,-0.209556326
Virginia,51089,Henry County,15207,8199,24029,7008,0.632860294,0.341212701,0.291647593
Virginia,51091,Highland County,958,371,1391,587,0.688713156,0.266714594,0.421998562
Virginia,51670,Hopewell city,3885,4722,8968,-837,0.433206958,0.526538805,-0.093331847
Virginia,51093,Isle of Wight County,11971,7673,20481,4298,0.584492945,0.37463991,0.209853035
Virginia,51095,James City County,21284,19091,42737,2193,0.498022791,0.446708941,0.05131385
Virginia,51097,King and Queen County,2059,1451,3615,608,0.569571231,0.401383126,0.168188105
Virginia,51099,King George County,7338,4002,11967,3336,0.613186262,0.334419654,0.278766608
Virginia,51101,King William County,5963,2752,9088,3211,0.656139965,0.302816901,0.353323064
Virginia,51103,Lancaster County,3520,2862,6599,658,0.533414154,0.433702076,0.099712078
Virginia,51105,Lee County,7542,1627,9353,5915,0.806372287,0.173954881,0.632417406
Virginia,51678,Lexington city,766,1514,2448,-748,0.312908497,0.618464052,-0.305555555
Virginia,51107,Loudoun County,69633,99909,180265,-30276,0.386281308,0.554234044,-0.167952736
Virginia,51109,Louisa County,10507,6208,17507,4299,0.600159936,0.354601017,0.245558919
Virginia,51111,Lunenburg County,3206,2226,5577,980,0.574861036,0.399139322,0.175721714
Virginia,51680,Lynchburg city,17979,14787,35349,3192,0.508614105,0.418314521,0.090299584
Virginia,51113,Madison County,4418,2202,6934,2216,0.637150274,0.317565619,0.319584655
Virginia,51683,Manassas city,5934,8395,15210,-2461,0.390138067,0.551939513,-0.161801446
Virginia,51685,Manassas Park city,1732,3218,5214,-1486,0.332182585,0.617184503,-0.285001918
Virginia,51690,Martinsville city,2149,3531,5873,-1382,0.3659118,0.601225949,-0.235314149
Virginia,51115,Mathews County,3515,1563,5292,1952,0.664210128,0.295351474,0.368858654
Virginia,51117,Mecklenburg County,8283,6571,15177,1712,0.545760032,0.432957765,0.112802267
Virginia,51119,Middlesex County,3668,2107,5994,1561,0.611945279,0.351518185,0.260427094
Virginia,51121,Montgomery County,19455,20015,42695,-560,0.455673967,0.468790256,-0.013116289
Virginia,51125,Nelson County,4150,3677,8247,473,0.50321329,0.4458591,0.05735419
Virginia,51127,New Kent County,8117,3545,12163,4572,0.667351805,0.2914577,0.375894105
Virginia,51700,Newport News city,23650,40997,68432,-17347,0.34559855,0.599091069,-0.253492519
Virginia,51710,Norfolk city,19875,51429,75172,-31554,0.264393657,0.684151014,-0.419757357
Virginia,51131,Northampton County,2686,3255,6134,-569,0.437887186,0.530648843,-0.092761657
Virginia,51133,Northumberland County,5089,2830,8176,2259,0.622431507,0.346135029,0.276296478
Virginia,51720,Norton city,1021,383,1456,638,0.701236264,0.263049451,0.438186813
Virginia,51135,Nottoway County,3712,2829,6717,883,0.552627661,0.421170165,0.131457496
Virginia,51137,Orange County,10511,5955,17157,4556,0.612636242,0.347088652,0.26554759
Virginia,51139,Page County,7824,2514,10663,5310,0.733752227,0.235768545,0.497983682
Virginia,51141,Patrick County,6454,1768,8489,4686,0.760278007,0.208269525,0.552008482
Virginia,51730,Petersburg city,1448,12005,13717,-10557,0.105562441,0.875191368,-0.769628927
Virginia,51143,Pittsylvania County,21742,9195,31687,12547,0.686148894,0.290182094,0.3959668
Virginia,51735,Poquoson city,5089,1599,7114,3490,0.715350014,0.224768063,0.490581951
Virginia,51740,Portsmouth city,12773,28462,43000,-15689,0.297046512,0.661906977,-0.364860465
Virginia,51145,Powhatan County,11875,4057,16794,7818,0.707097773,0.241574372,0.465523401
Virginia,51147,Prince Edward County,4099,4590,9113,-491,0.449796993,0.503676067,-0.053879074
Virginia,51149,Prince George County,9157,6419,16140,2738,0.567348203,0.397707559,0.169640644
Virginia,51153,Prince William County,54065,83093,144854,-29028,0.373237881,0.573632761,-0.20039488
Virginia,51155,Pulaski County,10314,4170,15112,6144,0.68250397,0.275939651,0.406564319
Virginia,51750,Radford city,2637,2923,6032,-286,0.437168435,0.484582228,-0.047413793
Virginia,51157,Rappahannock County,2532,1741,4444,791,0.569756976,0.391764176,0.1779928
Virginia,51159,Richmond County,2213,1347,3651,866,0.606135305,0.368940016,0.237195289
Virginia,51760,Richmond city,14254,74640,94724,-60386,0.150479287,0.787973481,-0.637494194
Virginia,51161,Roanoke County,30857,16787,50149,14070,0.615306387,0.334742467,0.28056392
Virginia,51770,Roanoke city,16045,23403,41728,-7358,0.384513995,0.560846434,-0.176332439
Virginia,51163,Rockbridge County,6671,3506,10685,3165,0.624333177,0.328123538,0.296209639
Virginia,51165,Rockingham County,25269,9361,36536,15908,0.691619225,0.25621305,0.435406175
Virginia,51167,Russell County,9516,2328,12195,7188,0.780319803,0.190897909,0.589421894
Virginia,51775,Salem city,7225,4212,12129,3013,0.595679776,0.347266881,0.248412895
Virginia,51169,Scott County,8242,1579,10055,6663,0.819691696,0.1570363,0.662655396
Virginia,51171,Shenandoah County,14078,5269,20335,8809,0.69230391,0.259109909,0.433194001
Virginia,51173,Smyth County,9747,2661,12825,7086,0.76,0.20748538,0.55251462
Virginia,51175,Southampton County,5035,3595,8872,1440,0.56751578,0.405207394,0.162308386
Virginia,51177,Spotsylvania County,34619,24204,62083,10415,0.55762447,0.38986518,0.16775929
Virginia,51179,Stafford County,33840,27879,65350,5961,0.517827085,0.426610559,0.091216526
Virginia,51790,Staunton city,5129,5329,11144,-200,0.460247667,0.478194544,-0.017946877
Virginia,51800,Suffolk city,17206,23012,41929,-5806,0.410360371,0.54883255,-0.138472179
Virginia,51181,Surry County,1785,2069,3976,-284,0.448943662,0.520372233,-0.071428571
Virginia,51183,Sussex County,2055,2874,5036,-819,0.408061954,0.570691025,-0.162629071
Virginia,51185,Tazewell County,15160,2895,18495,12265,0.819680995,0.156528792,0.663152203
Virginia,51810,Virginia Beach city,84389,76744,171876,7645,0.490987689,0.446507948,0.044479741
Virginia,51187,Warren County,11762,5165,17791,6597,0.661120791,0.290315328,0.370805463
Virginia,51191,Washington County,19309,5548,25715,13761,0.750884698,0.215749563,0.535135135
Virginia,51820,Waynesboro city,4798,3762,9114,1036,0.526442835,0.41277156,0.113671275
Virginia,51193,Westmoreland County,4331,3723,8291,608,0.522373658,0.449041129,0.073332529
Virginia,51830,Williamsburg city,1921,5199,7534,-3278,0.254977436,0.690071675,-0.435094239
Virginia,51840,Winchester city,4786,5161,10574,-375,0.452619633,0.48808398,-0.035464347
Virginia,51195,Wise County,11983,2687,14991,9296,0.799346274,0.179240878,0.620105396
Virginia,51197,Wythe County,10044,2765,13250,7279,0.758037736,0.208679245,0.549358491
Virginia,51199,York County,18823,12989,34062,5834,0.552609947,0.381334038,0.171275909
Vermont,50001,Addison County,5297,11217,17592,-5920,0.301102774,0.637619372,-0.336516598
Vermont,50003,Bennington County,5925,9539,16345,-3614,0.362496176,0.583603548,-0.221107372
Vermont,50005,Caledonia County,5533,6445,12966,-912,0.426731451,0.497069258,-0.070337807
Vermont,50007,Chittenden County,18298,54463,77263,-36165,0.236827459,0.704904029,-0.46807657
Vermont,50009,Essex County,1506,1019,2706,487,0.55654102,0.376570584,0.179970436
Vermont,50011,Franklin County,8752,9351,19373,-599,0.451762763,0.482682083,-0.03091932
Vermont,50013,Grand Isle County,1487,2094,3778,-607,0.393594494,0.554261514,-0.16066702
Vermont,50015,Lamoille County,3570,7241,11641,-3671,0.306674684,0.622025599,-0.315350915
Vermont,50017,Orange County,4997,7522,13464,-2525,0.371137849,0.558674985,-0.187537136
Vermont,50019,Orleans County,5158,5181,10988,-23,0.469421187,0.471514379,-0.002093192
Vermont,50021,Rutland County,12471,13629,27660,-1158,0.450867679,0.492733189,-0.04186551
Vermont,50023,Washington County,7993,18594,28654,-10601,0.278948838,0.648914637,-0.369965799
Vermont,50025,Windham County,5462,14340,21151,-8878,0.258238381,0.677982129,-0.419743748
Vermont,50027,Windsor County,8604,17544,27832,-8940,0.309140558,0.63035355,-0.321212992
Washington,53001,Adams County,2740,1118,4081,1622,0.671404068,0.273952463,0.397451605
Washington,53003,Asotin County,5712,3118,9684,2594,0.58983891,0.321974391,0.267864519
Washington,53005,Benton County,45594,25173,76907,20421,0.592845905,0.327317409,0.265528496
Washington,53007,Chelan County,15070,10770,27415,4300,0.54969907,0.392850629,0.156848441
Washington,53009,Clallam County,15685,15154,32985,531,0.475519175,0.459420949,0.016098226
Washington,53011,Clark County,90590,90697,195784,-107,0.462703796,0.463250317,-0.000546521
Washington,53013,Columbia County,1491,523,2171,968,0.686780286,0.24090281,0.445877476
Washington,53015,Cowlitz County,24066,17842,45485,6224,0.529097505,0.392261185,0.13683632
Washington,53017,Douglas County,7208,3600,11467,3608,0.628586378,0.313944362,0.314642016
Washington,53019,Ferry County,2178,1091,3560,1087,0.611797753,0.306460674,0.305337079
Washington,53021,Franklin County,11358,7839,20584,3519,0.551787796,0.380829771,0.170958025
Washington,53023,Garfield County,841,276,1232,565,0.68262987,0.224025974,0.458603896
Washington,53025,Grant County,18482,7768,28260,10714,0.653998585,0.27487615,0.379122435
Washington,53027,Grays Harbor County,13269,11378,26736,1891,0.496297127,0.425568522,0.070728605
Washington,53029,Island County,18259,20766,42425,-2507,0.430383029,0.489475545,-0.059092516
Washington,53031,Jefferson County,5986,12556,20100,-6570,0.297810945,0.624676617,-0.326865672
Washington,53033,King County,197781,657149,910823,-459368,0.217145373,0.721489247,-0.504343874
Washington,53035,Kitsap County,46762,60561,118625,-13799,0.394200211,0.510524763,-0.116324552
Washington,53037,Kittitas County,9845,7190,18334,2655,0.536980473,0.392167558,0.144812915
Washington,53039,Klickitat County,5390,3781,9859,1609,0.546708591,0.383507455,0.163201136
Washington,53041,Lewis County,16273,7236,24995,9037,0.65105021,0.2894979,0.36155231
Washington,53043,Lincoln County,4095,1238,5692,2857,0.71943078,0.217498243,0.501932537
Washington,53045,Mason County,13539,11872,27767,1667,0.487593186,0.427557892,0.060035294
Washington,53047,Okanogan County,6305,3980,10893,2325,0.578812081,0.365372257,0.213439824
Washington,53049,Pacific County,5338,4597,10667,741,0.500421862,0.430955283,0.069466579
Washington,53051,Pend Oreille County,4364,1932,6788,2432,0.642899234,0.284619918,0.358279316
Washington,53053,Pierce County,136046,160306,322592,-24260,0.421727755,0.496931108,-0.075203353
Washington,53055,San Juan County,2651,7053,10589,-4402,0.250354141,0.666068562,-0.415714421
Washington,53057,Skagit County,24330,26076,54831,-1746,0.443727089,0.475570389,-0.0318433
Washington,53059,Skamania County,2910,2207,5587,703,0.520851978,0.395024163,0.125827815
Washington,53061,Snohomish County,116433,167943,309496,-51510,0.376201954,0.54263383,-0.166431876
Washington,53063,Spokane County,103846,86590,208081,17256,0.499065268,0.416136024,0.082929244
Washington,53065,Stevens County,11059,4348,16438,6711,0.67277041,0.264509064,0.408261346
Washington,53067,Thurston County,46219,65015,122301,-18796,0.377911873,0.53159827,-0.153686397
Washington,53069,Wahkiakum County,1328,824,2333,504,0.569224175,0.353193313,0.216030862
Washington,53071,Walla Walla County,10775,7550,19718,3225,0.546455016,0.382898874,0.163556142
Washington,53073,Whatcom County,40247,59402,108223,-19155,0.371889524,0.548885172,-0.176995648
Washington,53075,Whitman County,5462,5521,12128,-59,0.450362797,0.455227573,-0.004864776
Washington,53077,Yakima County,39593,28484,72306,11109,0.547575582,0.393936879,0.153638703
Wisconsin,55001,Adams County,5983,3780,10107,2203,0.591965964,0.373998219,0.217967745
Wisconsin,55003,Ashland County,3428,4136,7926,-708,0.432500631,0.521826899,-0.089326268
Wisconsin,55005,Barron County,13595,7881,22514,5714,0.603846496,0.350048858,0.253797638
Wisconsin,55007,Bayfield County,4125,4953,9491,-828,0.434622274,0.521862817,-0.087240543
Wisconsin,55009,Brown County,67192,53358,127497,13834,0.527008479,0.418503965,0.108504514
Wisconsin,55011,Buffalo County,4049,2531,6921,1518,0.585031065,0.365698598,0.219332467
Wisconsin,55013,Burnett County,5412,2948,8719,2464,0.620713385,0.338112169,0.282601216
Wisconsin,55015,Calumet County,15345,9634,26429,5711,0.580612206,0.364523819,0.216088387
Wisconsin,55017,Chippewa County,17912,11875,31471,6037,0.569158908,0.377331512,0.191827396
Wisconsin,55019,Clark County,8645,4225,13548,4420,0.638101565,0.311854148,0.326247417
Wisconsin,55021,Columbia County,14160,13525,29287,635,0.483490969,0.461808994,0.021681975
Wisconsin,55023,Crawford County,3844,3426,7678,418,0.500651211,0.446209951,0.05444126
Wisconsin,55025,Dane County,71270,217506,304729,-146236,0.233879939,0.713768627,-0.479888688
Wisconsin,55027,Dodge County,26643,13968,42818,12675,0.622238311,0.326217946,0.296020365
Wisconsin,55029,Door County,8584,8026,17398,558,0.493390045,0.461317393,0.032072652
Wisconsin,55031,Douglas County,9657,11342,22185,-1685,0.435294118,0.511246338,-0.07595222
Wisconsin,55033,Dunn County,11487,9025,22029,2462,0.521448999,0.40968723,0.111761769
Wisconsin,55035,Eau Claire County,23301,27271,54080,-3970,0.430861686,0.50427145,-0.073409764
Wisconsin,55037,Florence County,1897,666,2651,1231,0.715579027,0.251225952,0.464353075
Wisconsin,55039,Fond du Lac County,31044,17391,51094,13653,0.607586018,0.340372646,0.267213372
Wisconsin,55041,Forest County,2787,1583,4507,1204,0.618371422,0.351231418,0.267140004
Wisconsin,55043,Grant County,12347,10047,24051,2300,0.513367428,0.417737308,0.09563012
Wisconsin,55045,Green County,8693,9121,18791,-428,0.462615082,0.485391943,-0.022776861
Wisconsin,55047,Green Lake County,6210,2700,9315,3510,0.666666667,0.289855072,0.376811595
Wisconsin,55049,Iowa County,4809,6669,12123,-1860,0.396683989,0.550111359,-0.15342737
Wisconsin,55051,Iron County,2090,1273,3477,817,0.601092896,0.366120219,0.234972677
Wisconsin,55053,Jackson County,4907,3821,9202,1086,0.533253641,0.415235818,0.118017823
Wisconsin,55055,Jefferson County,23409,16559,42324,6850,0.553090445,0.391243739,0.161846706
Wisconsin,55057,Juneau County,7188,4100,11736,3088,0.612474438,0.34935242,0.263122018
Wisconsin,55059,Kenosha County,36025,35770,75825,255,0.475107155,0.471744148,0.003363007
Wisconsin,55061,Kewaunee County,6616,3623,10742,2993,0.615900205,0.337274251,0.278625954
Wisconsin,55063,La Crosse County,26384,32402,62785,-6018,0.420227761,0.516078681,-0.09585092
Wisconsin,55065,Lafayette County,3977,3288,7602,689,0.523151802,0.432517758,0.090634044
Wisconsin,55067,Langlade County,6436,3260,10093,3176,0.637669672,0.322996136,0.314673536
Wisconsin,55069,Lincoln County,8400,5370,14563,3030,0.57680423,0.368742704,0.208061526
Wisconsin,55071,Manitowoc County,23234,14563,39991,8671,0.580980721,0.364156935,0.216823786
Wisconsin,55073,Marathon County,39010,26476,68849,12534,0.566602275,0.3845517,0.182050575
Wisconsin,55075,Marinette County,12995,6243,19979,6752,0.650432955,0.312478102,0.337954853
Wisconsin,55077,Marquette County,4712,2808,7813,1904,0.603097402,0.359400998,0.243696404
Wisconsin,55078,Menominee County,269,1003,1279,-734,0.210320563,0.784206411,-0.573885848
Wisconsin,55079,Milwaukee County,126091,288986,434970,-162895,0.28988436,0.664381452,-0.374497092
Wisconsin,55081,Monroe County,11442,7047,19554,4395,0.585148819,0.360386622,0.224762197
Wisconsin,55083,Oconto County,13255,5886,19924,7369,0.665278057,0.295422606,0.369855451
Wisconsin,55085,Oneida County,11677,8103,20837,3574,0.56039737,0.388875558,0.171521812
Wisconsin,55087,Outagamie County,49884,38087,93474,11797,0.533667116,0.407460898,0.126206218
Wisconsin,55089,Ozaukee County,30458,20167,53368,10291,0.570716534,0.377885624,0.19283091
Wisconsin,55091,Pepin County,2228,1345,3746,883,0.594767752,0.359049653,0.235718099
Wisconsin,55093,Pierce County,11260,8380,21089,2880,0.53392764,0.397363554,0.136564086
Wisconsin,55095,Polk County,13864,7568,22691,6296,0.610991142,0.333524305,0.277466837
Wisconsin,55097,Portage County,17310,18524,38123,-1214,0.454056606,0.4859009,-0.031844294
Wisconsin,55099,Price County,4562,2671,7560,1891,0.603439153,0.353306878,0.250132275
Wisconsin,55101,Racine County,46620,42506,93678,4114,0.497662205,0.45374581,0.043916395
Wisconsin,55103,Richland County,4021,3577,7962,444,0.505023863,0.44925898,0.055764883
Wisconsin,55105,Rock County,31483,39336,75043,-7853,0.419532801,0.52417947,-0.104646669
Wisconsin,55107,Rusk County,4564,2171,7029,2393,0.649310001,0.308863281,0.34044672
Wisconsin,55111,Sauk County,14791,14692,31238,99,0.473493822,0.470324605,0.003169217
Wisconsin,55113,Sawyer County,4625,2846,7767,1779,0.595468006,0.366422042,0.229045964
Wisconsin,55115,Shawano County,12742,6056,19697,6686,0.646900543,0.307457989,0.339442554
Wisconsin,55117,Sheboygan County,32368,22636,58290,9732,0.555292503,0.388334191,0.166958312
Wisconsin,55109,St. Croix County,26123,17496,46819,8627,0.55795724,0.37369444,0.1842628
Wisconsin,55119,Taylor County,6589,2398,9417,4191,0.699692046,0.254645853,0.445046193
Wisconsin,55121,Trempealeau County,7370,5645,13581,1725,0.542669906,0.415654223,0.127015683
Wisconsin,55123,Vernon County,6994,6351,14193,643,0.49277813,0.447474107,0.045304023
Wisconsin,55125,Vilas County,8169,4769,13453,3400,0.607225154,0.354493422,0.252731732
Wisconsin,55127,Walworth County,28848,18706,50570,10142,0.570456793,0.369903105,0.200553688
Wisconsin,55129,Washburn County,5404,3283,9059,2121,0.596533834,0.362402031,0.234131803
Wisconsin,55131,Washington County,51729,20854,76246,30875,0.678448706,0.27350943,0.404939276
Wisconsin,55133,Waukesha County,142521,79200,233273,63321,0.610962263,0.339516361,0.271445902
Wisconsin,55135,Waupaca County,16013,8303,25491,7710,0.628182496,0.325722804,0.302459692
Wisconsin,55137,Waushara County,7669,3802,11961,3867,0.641167126,0.317866399,0.323300727
Wisconsin,55139,Winnebago County,43447,37054,85892,6393,0.505832906,0.431402226,0.07443068
Wisconsin,55141,Wood County,21502,14232,37712,7270,0.570163343,0.377386508,0.192776835
West Virginia,54001,Barbour County,4509,1213,6024,3296,0.748505976,0.201361222,0.547144754
West Virginia,54003,Berkeley County,28210,12287,42770,15923,0.659574468,0.287280804,0.372293664
West Virginia,54005,Boone County,6483,1783,8654,4700,0.749133349,0.206031893,0.543101456
West Virginia,54007,Braxton County,3516,1315,5063,2201,0.694449931,0.259727434,0.434722497
West Virginia,54009,Brooke County,6574,2549,9540,4025,0.689098532,0.267190776,0.421907756
West Virginia,54011,Cabell County,19648,11306,32701,8342,0.600837895,0.345738662,0.255099233
West Virginia,54013,Calhoun County,2023,456,2604,1567,0.77688172,0.175115207,0.601766513
West Virginia,54015,Clay County,2289,566,2958,1723,0.773833671,0.191345504,0.582488167
West Virginia,54017,Doddridge County,2347,360,2826,1987,0.830502477,0.127388535,0.703113942
West Virginia,54019,Fayette County,10263,4246,15187,6017,0.675775334,0.279581221,0.396194113
West Virginia,54021,Gilmer County,1889,537,2528,1352,0.747231013,0.212420886,0.534810127
West Virginia,54023,Grant County,4338,510,4945,3828,0.877249747,0.103134479,0.774115268
West Virginia,54025,Greenbrier County,9499,3743,13984,5756,0.679276316,0.267663043,0.411613273
West Virginia,54027,Hampshire County,6646,1576,8557,5070,0.776674068,0.184176697,0.592497371
West Virginia,54029,Hancock County,8870,3247,12642,5623,0.701629489,0.256842272,0.444787217
West Virginia,54031,Hardy County,4544,1249,6022,3295,0.754566589,0.207406177,0.547160412
West Virginia,54033,Harrison County,18687,7675,27868,11012,0.67055404,0.275405483,0.395148557
West Virginia,54035,Jackson County,8959,2648,12108,6311,0.739924017,0.218698381,0.521225636
West Virginia,54037,Jefferson County,13144,9458,24007,3686,0.547506977,0.393968426,0.153538551
West Virginia,54039,Kanawha County,43464,27985,74996,15479,0.579550909,0.373153235,0.206397674
West Virginia,54041,Lewis County,5245,1336,6885,3909,0.761801017,0.194045025,0.567755992
West Virginia,54043,Lincoln County,5257,1435,6988,3822,0.752289639,0.205352032,0.546937607
West Virginia,54045,Logan County,9866,2082,12315,7784,0.801136825,0.169062119,0.632074706
West Virginia,54049,Marion County,14592,6926,22910,7666,0.636927106,0.3023134,0.334613706
West Virginia,54051,Marshall County,9565,2894,13083,6671,0.731101429,0.221203088,0.509898341
West Virginia,54053,Mason County,7597,2069,10115,5528,0.751062778,0.204547701,0.546515077
West Virginia,54047,McDowell County,4614,1429,6179,3185,0.746722771,0.231267195,0.515455576
West Virginia,54055,Mercer County,17362,4689,22919,12673,0.757537414,0.204590078,0.552947336
West Virginia,54057,Mineral County,8957,2019,11410,6938,0.785013146,0.176950044,0.608063102
West Virginia,54059,Mingo County,7876,1365,9469,6511,0.831766818,0.14415461,0.687612208
West Virginia,54061,Monongalia County,18278,14568,35733,3710,0.511515966,0.40769037,0.103825596
West Virginia,54063,Monroe County,4337,1089,5670,3248,0.764902998,0.192063492,0.572839506
West Virginia,54065,Morgan County,5718,1568,7635,4150,0.74891945,0.205370007,0.543549443
West Virginia,54067,Nicholas County,7169,1821,9385,5348,0.76387853,0.194033031,0.569845499
West Virginia,54069,Ohio County,11077,5452,17819,5625,0.621639823,0.305965542,0.315674281
West Virginia,54071,Pendleton County,2388,726,3212,1662,0.743462017,0.226027397,0.51743462
West Virginia,54073,Pleasants County,2342,620,3130,1722,0.748242812,0.198083067,0.550159745
West Virginia,54075,Pocahontas County,2474,924,3619,1550,0.683614258,0.255319149,0.428295109
West Virginia,54077,Preston County,9501,2462,12611,7039,0.753389898,0.19522639,0.558163508
West Virginia,54079,Putnam County,17455,5784,24443,11671,0.714110379,0.236632165,0.477478214
West Virginia,54081,Raleigh County,21835,6362,29311,15473,0.744942172,0.217051619,0.527890553
West Virginia,54083,Randolph County,7583,2724,10816,4859,0.701090976,0.251849112,0.449241864
West Virginia,54085,Ritchie County,3376,490,4040,2886,0.835643564,0.121287129,0.714356435
West Virginia,54087,Roane County,3772,1220,5234,2552,0.720672526,0.233091326,0.4875812
West Virginia,54089,Summers County,3444,1186,4847,2258,0.710542604,0.244687436,0.465855168
West Virginia,54091,Taylor County,4701,1483,6498,3218,0.72345337,0.228224069,0.495229301
West Virginia,54093,Tucker County,2557,750,3464,1807,0.738163972,0.216512702,0.52165127
West Virginia,54095,Tyler County,2967,505,3621,2462,0.81938691,0.139464236,0.679922674
West Virginia,54097,Upshur County,6971,1763,9180,5208,0.759368192,0.19204793,0.567320262
West Virginia,54099,Wayne County,11077,3334,15080,7743,0.734549072,0.221087533,0.513461539
West Virginia,54101,Webster County,2284,554,2955,1730,0.772927242,0.187478849,0.585448393
West Virginia,54103,Wetzel County,4461,1348,6191,3113,0.720562106,0.217735422,0.502826684
West Virginia,54105,Wirt County,1903,383,2410,1520,0.789626556,0.158921162,0.630705394
West Virginia,54107,Wood County,25168,8327,35256,16841,0.713864307,0.236186748,0.477677559
West Virginia,54109,Wyoming County,6527,1061,7809,5466,0.835830452,0.135868869,0.699961583
Wyoming,56001,Albany County,7601,6888,16420,713,0.462911084,0.419488429,0.043422655
Wyoming,56003,Big Horn County,4067,594,5079,3473,0.800748179,0.116952156,0.683796023
Wyoming,56005,Campbell County,15778,1324,17935,14454,0.879732367,0.073822135,0.805910232
Wyoming,56007,Carbon County,4409,1279,6200,3130,0.711129032,0.206290323,0.504838709
Wyoming,56009,Converse County,5520,668,6552,4852,0.842490842,0.101953602,0.74053724
Wyoming,56011,Crook County,3347,271,3771,3076,0.887562981,0.071864227,0.815698754
Wyoming,56013,Fremont County,11167,4200,16543,6967,0.675028713,0.253883818,0.421144895
Wyoming,56015,Goshen County,4418,924,5708,3494,0.774001402,0.161878066,0.612123336
Wyoming,56017,Hot Springs County,1939,400,2535,1539,0.764891519,0.157790927,0.607100592
Wyoming,56019,Johnson County,3477,638,4349,2839,0.799494137,0.146700391,0.652793746
Wyoming,56021,Laramie County,24844,11572,39945,13272,0.621955188,0.289698335,0.332256853
Wyoming,56023,Lincoln County,6779,1105,8398,5674,0.807216004,0.131578947,0.675637057
Wyoming,56025,Natrona County,23523,6573,32493,16950,0.723940541,0.202289724,0.521650817
Wyoming,56027,Niobrara County,1116,115,1297,1001,0.860447186,0.088666153,0.771781033
Wyoming,56029,Park County,11115,2535,14634,8580,0.759532595,0.173226732,0.586305863
Wyoming,56031,Platte County,3437,719,4460,2718,0.770627803,0.161210762,0.609417041
Wyoming,56033,Sheridan County,10266,2926,14187,7340,0.723620216,0.206245154,0.517375062
Wyoming,56035,Sublette County,3409,644,4297,2765,0.793344194,0.149872004,0.64347219
Wyoming,56037,Sweetwater County,12153,3233,16661,8920,0.729428006,0.194045976,0.53538203
Wyoming,56039,Teton County,3920,7313,12176,-3393,0.321944809,0.600607753,-0.278662944
Wyoming,56041,Uinta County,6154,1202,8053,4952,0.764187259,0.149261145,0.614926114
Wyoming,56043,Washakie County,2911,532,3715,2379,0.783580081,0.14320323,0.640376851
Wyoming,56045,Weston County,2898,294,3334,2604,0.869226155,0.088182364,0.781043791
